,Country,Region,Year,Status,PR rating,CL rating,PR,CL,Total
0,Abkhazia,Eurasia,2024,PF,5,5,17,22,39
1,Afghanistan,Asia,2024,NF,7,7,1,5,6
2,Albania,Europe,2024,PF,3,3,28,40,68
3,Algeria,Africa,2024,NF,6,5,10,22,32
4,Andorra,Europe,2024,F,1,1,38,55,93
5,Angola,Africa,2024,NF,6,5,10,18,28
6,Antigua and Barbuda,Americas,2024,F,2,2,33,52,85
7,Argentina,Americas,2024,F,2,2,35,50,85
8,Armenia,Eurasia,2024,PF,4,4,23,31,54
9,Australia,Asia,2024,F,1,1,38,57,95
10,Austria,Europe,2024,F,1,1,37,56,93
11,Azerbaijan,Eurasia,2024,NF,7,7,0,7,7
12,Bahamas,Americas,2024,F,1,1,38,53,91
13,Bahrain,Middle East,2024,NF,7,6,2,10,12
14,Bangladesh,Asia,2024,PF,5,5,15,25,40
15,Barbados,Americas,2024,F,1,1,37,57,94
16,Belarus,Eurasia,2024,NF,7,7,2,6,8
17,Belgium,Europe,2024,F,1,1,39,57,96
18,Belize,Americas,2024,F,2,1,34,53,87
19,Benin,Africa,2024,PF,4,3,19,42,61
20,Bhutan,Asia,2024,PF,2,4,30,33,63
21,Bolivia,Americas,2024,PF,3,3,27,39,66
22,Bosnia and Herzegovina,Europe,2024,PF,5,4,17,34,51
23,Botswana,Africa,2024,F,3,2,28,44,72
24,Brazil,Americas,2024,F,2,3,30,42,72
25,Brunei,Asia,2024,NF,6,5,7,21,28
26,Bulgaria,Europe,2024,F,2,2,32,46,78
27,Burkina Faso,Africa,2024,NF,7,5,3,24,27
28,Burundi,Africa,2024,NF,7,6,4,10,14
29,Cabo Verde,Africa,2024,F,1,1,38,54,92
30,Cambodia,Asia,2024,NF,7,5,4,19,23
31,Cameroon,Africa,2024,NF,6,6,6,9,15
32,Canada,Americas,2024,F,1,1,39,58,97
33,Central African Republic,Africa,2024,NF,7,7,1,4,5
34,Chad,Africa,2024,NF,7,6,1,14,15
35,Chile,Americas,2024,F,1,1,38,56,94
36,China,Asia,2024,NF,7,6,-2,11,9
37,Colombia,Americas,2024,F,2,3,31,39,70
38,Comoros,Africa,2024,PF,5,4,16,26,42
39,Congo (Brazzaville),Africa,2024,NF,7,6,2,15,17
40,Congo (Kinshasa),Africa,2024,NF,7,6,4,15,19
41,Costa Rica,Americas,2024,F,1,1,38,53,91
42,Cote d'Ivoire,Africa,2024,PF,4,4,19,30,49
43,Crimea,Eurasia,2024,NF,7,7,-2,4,2
44,Croatia,Europe,2024,F,2,2,34,49,83
45,Cuba,Americas,2024,NF,7,6,1,11,12
46,Cyprus,Europe,2024,F,1,1,38,54,92
47,Czech Republic,Europe,2024,F,1,1,36,58,94
48,Denmark,Europe,2024,F,1,1,40,57,97
49,Djibouti,Africa,2024,NF,7,5,5,19,24
50,Dominica,Americas,2024,F,1,1,37,56,93
51,Dominican Republic,Americas,2024,PF,3,3,27,41,68
52,Eastern Donbas,Eurasia,2024,NF,7,7,-1,4,3
53,Ecuador,Americas,2024,PF,3,3,29,38,67
54,Egypt,Africa,2024,NF,6,6,6,12,18
55,El Salvador,Americas,2024,PF,4,4,21,32,53
56,Equatorial Guinea,Africa,2024,NF,7,7,0,5,5
57,Eritrea,Africa,2024,NF,7,7,1,2,3
58,Estonia,Europe,2024,F,1,1,38,57,95
59,Eswatini,Africa,2024,NF,7,6,1,16,17
60,Ethiopia,Africa,2024,NF,6,6,10,10,20
61,Fiji,Asia,2024,PF,3,3,27,39,66
62,Finland,Europe,2024,F,1,1,40,60,100
63,France,Europe,2024,F,1,2,38,51,89
64,Gabon,Africa,2024,NF,7,5,2,18,20
65,Gaza Strip,Middle East,2024,NF,7,7,3,5,8
66,Georgia,Eurasia,2024,PF,4,3,22,36,58
67,Germany,Europe,2024,F,1,1,39,54,93
68,Ghana,Africa,2024,F,2,2,35,45,80
69,Greece,Europe,2024,F,2,2,35,50,85
70,Grenada,Americas,2024,F,1,2,37,52,89
71,Guatemala,Americas,2024,PF,5,4,17,29,46
72,Guinea,Africa,2024,NF,6,5,7,23,30
73,Guinea-Bissau,Africa,2024,PF,5,4,17,26,43
74,Guyana,Americas,2024,F,2,3,30,43,73
75,Haiti,Americas,2024,NF,6,5,11,19,30
76,Honduras,Americas,2024,PF,4,4,22,26,48
77,Hong Kong,Asia,2024,PF,6,4,9,32,41
78,Hungary,Europe,2024,PF,3,3,24,41,65
79,Iceland,Europe,2024,F,1,1,37,57,94
80,India,Asia,2024,PF,2,4,33,33,66
81,Indian Kashmir,Asia,2024,NF,6,5,6,20,26
82,Indonesia,Asia,2024,PF,3,4,29,28,57
83,Iran,Middle East,2024,NF,7,7,4,7,11
84,Iraq,Middle East,2024,NF,5,6,16,14,30
85,Ireland,Europe,2024,F,1,1,39,58,97
86,Israel,Middle East,2024,F,2,3,34,40,74
87,Italy,Europe,2024,F,1,1,36,54,90
88,Jamaica,Americas,2024,F,2,2,33,47,80
89,Japan,Asia,2024,F,1,1,40,56,96
90,Jordan,Middle East,2024,NF,6,5,11,22,33
91,Kazakhstan,Eurasia,2024,NF,7,5,5,18,23
92,Kenya,Africa,2024,PF,4,4,22,30,52
93,Kiribati,Asia,2024,F,1,1,37,53,90
94,Kosovo,Europe,2024,PF,3,4,28,32,60
95,Kuwait,Middle East,2024,PF,5,5,14,24,38
96,Kyrgyzstan,Eurasia,2024,NF,7,5,4,23,27
97,Laos,Asia,2024,NF,7,6,2,11,13
98,Latvia,Europe,2024,F,1,2,37,51,88
99,Lebanon,Middle East,2024,PF,5,4,13,29,42
100,Lesotho,Africa,2024,F,2,3,30,36,66
101,Liberia,Africa,2024,PF,2,4,30,34,64
102,Libya,Africa,2024,NF,7,6,1,8,9
103,Liechtenstein,Europe,2024,F,2,1,33,57,90
104,Lithuania,Europe,2024,F,1,2,38,51,89
105,Luxembourg,Europe,2024,F,1,1,38,59,97
106,Madagascar,Africa,2024,PF,3,4,24,34,58
107,Malawi,Africa,2024,PF,3,3,29,37,66
108,Malaysia,Asia,2024,PF,4,4,22,31,53
109,Maldives,Asia,2024,PF,4,5,21,23,44
110,Mali,Africa,2024,NF,6,5,6,20,26
111,Malta,Europe,2024,F,2,2,35,52,87
112,Marshall Islands,Asia,2024,F,1,1,38,55,93
113,Mauritania,Africa,2024,PF,5,5,15,24,39
114,Mauritius,Africa,2024,F,2,2,35,50,85
115,Mexico,Americas,2024,PF,3,4,27,33,60
116,Micronesia,Asia,2024,F,1,1,37,55,92
117,Moldova,Eurasia,2024,PF,3,3,26,35,61
118,Monaco,Europe,2024,F,3,1,25,57,82
119,Mongolia,Asia,2024,F,1,2,36,48,84
120,Montenegro,Europe,2024,PF,3,3,27,42,69
121,Morocco,Africa,2024,PF,5,5,13,24,37
122,Mozambique,Africa,2024,PF,5,4,14,30,44
123,Myanmar,Asia,2024,NF,7,6,0,8,8
124,Nagorno-Karabakh,Eurasia,2024,NF,7,7,-3,0,-3
125,Namibia,Africa,2024,F,2,2,31,46,77
126,Nauru,Asia,2024,F,2,3,34,43,77
127,Nepal,Asia,2024,PF,3,4,28,34,62
128,Netherlands,Europe,2024,F,1,1,39,58,97
129,New Zealand,Asia,2024,F,1,1,40,59,99
130,Nicaragua,Americas,2024,NF,7,6,4,12,16
131,Niger,Africa,2024,PF,6,4,6,27,33
132,Nigeria,Africa,2024,PF,4,5,20,24,44
133,North Korea,Asia,2024,NF,7,7,0,3,3
134,North Macedonia,Europe,2024,PF,3,3,28,39,67
135,Northern Cyprus,Europe,2024,F,3,2,27,49,76
136,Norway,Europe,2024,F,1,1,39,59,98
137,Oman,Middle East,2024,NF,6,5,6,18,24
138,Pakistan,Asia,2024,PF,5,5,14,21,35
139,Pakistani Kashmir,Asia,2024,NF,6,5,9,20,29
140,Palau,Asia,2024,F,1,1,37,55,92
141,Panama,Americas,2024,F,2,2,35,48,83
142,Papua New Guinea,Asia,2024,PF,4,3,22,39,61
143,Paraguay,Americas,2024,PF,3,3,26,37,63
144,Peru,Americas,2024,PF,3,3,27,39,66
145,Philippines,Asia,2024,PF,3,4,25,33,58
146,Poland,Europe,2024,F,2,2,33,47,80
147,Portugal,Europe,2024,F,1,1,39,57,96
148,Qatar,Middle East,2024,NF,6,5,7,18,25
149,Romania,Europe,2024,F,2,2,35,48,83
150,Russia,Eurasia,2024,NF,7,6,4,9,13
151,Rwanda,Africa,2024,NF,6,6,8,15,23
152,Samoa,Asia,2024,F,2,2,32,52,84
153,San Marino,Europe,2024,F,1,1,39,58,97
154,Sao Tome and Principe,Africa,2024,F,2,2,35,49,84
155,Saudi Arabia,Middle East,2024,NF,7,7,1,7,8
156,Senegal,Africa,2024,PF,3,3,28,39,67
157,Serbia,Europe,2024,PF,4,3,18,39,57
158,Seychelles,Africa,2024,F,2,2,34,45,79
159,Sierra Leone,Africa,2024,PF,3,3,24,36,60
160,Singapore,Asia,2024,PF,4,4,19,29,48
161,Slovakia,Europe,2024,F,1,1,37,53,90
162,Slovenia,Europe,2024,F,1,1,39,57,96
163,Solomon Islands,Asia,2024,F,3,2,28,47,75
164,Somalia,Africa,2024,NF,7,7,2,6,8
165,Somaliland,Africa,2024,PF,5,4,17,26,43
166,South Africa,Africa,2024,F,2,2,33,46,79
167,South Korea,Asia,2024,F,2,2,33,50,83
168,South Ossetia,Eurasia,2024,NF,7,6,3,9,12
169,South Sudan,Africa,2024,NF,7,7,-3,4,1
170,Spain,Europe,2024,F,1,1,37,53,90
171,Sri Lanka,Asia,2024,PF,4,4,22,32,54
172,St. Kitts and Nevis,Americas,2024,F,2,1,35,54,89
173,St. Lucia,Americas,2024,F,1,1,38,54,92
174,St. Vincent and the Grenadines,Americas,2024,F,1,1,36,54,90
175,Sudan,Africa,2024,NF,7,6,-3,9,6
176,Suriname,Americas,2024,F,2,2,34,45,79
177,Sweden,Europe,2024,F,1,1,40,59,99
178,Switzerland,Europe,2024,F,1,1,39,57,96
179,Syria,Middle East,2024,NF,7,7,-3,4,1
180,Taiwan,Asia,2024,F,1,1,38,56,94
181,Tajikistan,Eurasia,2024,NF,7,7,0,5,5
182,Tanzania,Africa,2024,PF,5,5,12,24,36
183,Thailand,Asia,2024,PF,5,5,12,24,36
184,The Gambia,Africa,2024,PF,4,4,22,28,50
185,Tibet,Asia,2024,NF,7,7,-2,2,0
186,Timor-Leste,Asia,2024,F,2,3,33,39,72
187,Togo,Africa,2024,PF,5,4,15,27,42
188,Tonga,Asia,2024,F,2,2,31,50,81
189,Transnistria,Eurasia,2024,NF,7,6,5,12,17
190,Trinidad and Tobago,Americas,2024,F,2,2,33,49,82
191,Tunisia,Africa,2024,PF,5,3,16,35,51
192,Turkey,Europe,2024,NF,5,6,17,16,33
193,Turkmenistan,Eurasia,2024,NF,7,7,0,2,2
194,Tuvalu,Asia,2024,F,1,1,37,56,93
195,Uganda,Africa,2024,NF,6,5,10,24,34
196,Ukraine,Eurasia,2024,PF,4,4,21,28,49
197,United Arab Emirates,Middle East,2024,NF,7,6,5,13,18
198,United Kingdom,Europe,2024,F,1,1,38,53,91
199,United States,Americas,2024,F,2,2,33,50,83
200,Uruguay,Americas,2024,F,1,1,40,56,96
201,Uzbekistan,Eurasia,2024,NF,7,6,2,10,12
202,Vanuatu,Asia,2024,F,2,2,32,50,82
203,Venezuela,Americas,2024,NF,7,6,1,14,15
204,Vietnam,Asia,2024,NF,7,6,4,15,19
205,West Bank,Middle East,2024,NF,7,5,4,18,22
206,Western Sahara,Africa,2024,NF,7,7,-3,7,4
207,Yemen,Middle East,2024,NF,7,6,1,9,10
208,Zambia,Africa,2024,PF,4,4,23,31,54
209,Zimbabwe,Africa,2024,NF,6,5,10,17,27
210,Abkhazia,Eurasia,2023,PF,5,5,17,22,39
211,Afghanistan,Asia,2023,NF,7,7,1,7,8
212,Albania,Europe,2023,PF,3,3,28,39,67
213,Algeria,Africa,2023,NF,6,5,10,22,32
214,Andorra,Europe,2023,F,1,1,38,55,93
215,Angola,Africa,2023,NF,6,5,10,18,28
216,Antigua and Barbuda,Americas,2023,F,2,2,33,52,85
217,Argentina,Americas,2023,F,2,2,35,50,85
218,Armenia,Eurasia,2023,PF,4,4,23,31,54
219,Australia,Asia,2023,F,1,1,38,57,95
220,Austria,Europe,2023,F,1,1,37,56,93
221,Azerbaijan,Eurasia,2023,NF,7,7,2,7,9
222,Bahamas,Americas,2023,F,1,1,38,53,91
223,Bahrain,Middle East,2023,NF,7,6,2,10,12
224,Bangladesh,Asia,2023,PF,5,5,15,25,40
225,Barbados,Americas,2023,F,1,1,37,57,94
226,Belarus,Eurasia,2023,NF,7,7,2,6,8
227,Belgium,Europe,2023,F,1,1,39,57,96
228,Belize,Americas,2023,F,2,1,34,53,87
229,Benin,Africa,2023,PF,5,3,17,42,59
230,Bhutan,Asia,2023,PF,3,4,29,32,61
231,Bolivia,Americas,2023,PF,3,3,27,39,66
232,Bosnia and Herzegovina,Europe,2023,PF,4,4,18,34,52
233,Botswana,Africa,2023,F,3,2,28,44,72
234,Brazil,Americas,2023,F,2,3,30,42,72
235,Brunei,Asia,2023,NF,6,5,7,21,28
236,Bulgaria,Europe,2023,F,2,2,33,46,79
237,Burkina Faso,Africa,2023,NF,7,4,3,27,30
238,Burundi,Africa,2023,NF,7,6,4,10,14
239,Cabo Verde,Africa,2023,F,1,1,38,54,92
240,Cambodia,Asia,2023,NF,7,5,5,19,24
241,Cameroon,Africa,2023,NF,6,6,6,9,15
242,Canada,Americas,2023,F,1,1,40,58,98
243,Central African Republic,Africa,2023,NF,7,7,3,4,7
244,Chad,Africa,2023,NF,7,6,1,14,15
245,Chile,Americas,2023,F,1,1,38,56,94
246,China,Asia,2023,NF,7,6,-2,11,9
247,Colombia,Americas,2023,F,2,3,31,39,70
248,Comoros,Africa,2023,PF,5,4,16,26,42
249,Congo (Brazzaville),Africa,2023,NF,7,6,2,15,17
250,Congo (Kinshasa),Africa,2023,NF,7,6,4,15,19
251,Costa Rica,Americas,2023,F,1,1,38,53,91
252,Cote d'Ivoire,Africa,2023,PF,4,4,19,30,49
253,Crimea,Eurasia,2023,NF,7,7,-2,6,4
254,Croatia,Europe,2023,F,2,2,35,49,84
255,Cuba,Americas,2023,NF,7,6,1,11,12
256,Cyprus,Europe,2023,F,1,1,38,54,92
257,Czech Republic,Europe,2023,F,1,1,36,56,92
258,Denmark,Europe,2023,F,1,1,40,57,97
259,Djibouti,Africa,2023,NF,7,5,5,19,24
260,Dominica,Americas,2023,F,1,1,37,56,93
261,Dominican Republic,Americas,2023,PF,3,3,27,41,68
262,Eastern Donbas,Eurasia,2023,NF,7,7,-1,4,3
263,Ecuador,Americas,2023,F,2,3,30,40,70
264,Egypt,Africa,2023,NF,6,6,6,12,18
265,El Salvador,Americas,2023,PF,3,4,25,31,56
266,Equatorial Guinea,Africa,2023,NF,7,7,0,5,5
267,Eritrea,Africa,2023,NF,7,7,1,2,3
268,Estonia,Europe,2023,F,1,1,38,56,94
269,Eswatini,Africa,2023,NF,7,6,1,16,17
270,Ethiopia,Africa,2023,NF,6,6,10,11,21
271,Fiji,Asia,2023,PF,3,3,24,35,59
272,Finland,Europe,2023,F,1,1,40,60,100
273,France,Europe,2023,F,1,2,38,51,89
274,Gabon,Africa,2023,NF,7,5,2,18,20
275,Gaza Strip,Middle East,2023,NF,7,6,3,8,11
276,Georgia,Eurasia,2023,PF,4,3,22,36,58
277,Germany,Europe,2023,F,1,1,39,55,94
278,Ghana,Africa,2023,F,2,2,35,45,80
279,Greece,Europe,2023,F,2,2,35,51,86
280,Grenada,Americas,2023,F,1,2,37,52,89
281,Guatemala,Americas,2023,PF,4,4,20,29,49
282,Guinea,Africa,2023,NF,6,5,7,23,30
283,Guinea-Bissau,Africa,2023,PF,5,4,17,26,43
284,Guyana,Americas,2023,F,2,3,30,43,73
285,Haiti,Americas,2023,NF,6,5,11,20,31
286,Honduras,Americas,2023,PF,4,4,22,26,48
287,Hong Kong,Asia,2023,PF,6,4,10,32,42
288,Hungary,Europe,2023,PF,3,3,24,42,66
289,Iceland,Europe,2023,F,1,1,37,57,94
290,India,Asia,2023,PF,2,4,33,33,66
291,Indian Kashmir,Asia,2023,NF,6,5,7,20,27
292,Indonesia,Asia,2023,PF,2,4,30,28,58
293,Iran,Middle East,2023,NF,7,6,4,8,12
294,Iraq,Middle East,2023,NF,5,6,16,13,29
295,Ireland,Europe,2023,F,1,1,39,58,97
296,Israel,Middle East,2023,F,2,3,34,43,77
297,Italy,Europe,2023,F,1,1,36,54,90
298,Jamaica,Americas,2023,F,2,2,34,46,80
299,Japan,Asia,2023,F,1,1,40,56,96
300,Jordan,Middle East,2023,NF,6,5,11,22,33
301,Kazakhstan,Eurasia,2023,NF,7,5,5,18,23
302,Kenya,Africa,2023,PF,4,4,22,30,52
303,Kiribati,Asia,2023,F,1,1,37,54,91
304,Kosovo,Europe,2023,PF,3,4,28,32,60
305,Kuwait,Middle East,2023,PF,5,5,14,23,37
306,Kyrgyzstan,Eurasia,2023,NF,7,5,4,23,27
307,Laos,Asia,2023,NF,7,6,2,11,13
308,Latvia,Europe,2023,F,1,2,37,51,88
309,Lebanon,Middle East,2023,PF,5,4,14,29,43
310,Lesotho,Africa,2023,F,2,3,30,36,66
311,Liberia,Africa,2023,PF,3,4,27,33,60
312,Libya,Africa,2023,NF,7,6,1,9,10
313,Liechtenstein,Europe,2023,F,2,1,33,57,90
314,Lithuania,Europe,2023,F,1,2,38,51,89
315,Luxembourg,Europe,2023,F,1,1,38,59,97
316,Madagascar,Africa,2023,PF,3,4,27,34,61
317,Malawi,Africa,2023,PF,3,3,29,37,66
318,Malaysia,Asia,2023,PF,4,4,22,31,53
319,Maldives,Asia,2023,PF,4,5,19,22,41
320,Mali,Africa,2023,NF,6,5,8,21,29
321,Malta,Europe,2023,F,2,1,35,54,89
322,Marshall Islands,Asia,2023,F,1,1,38,55,93
323,Mauritania,Africa,2023,PF,5,5,14,22,36
324,Mauritius,Africa,2023,F,2,2,35,50,85
325,Mexico,Americas,2023,PF,3,4,27,33,60
326,Micronesia,Asia,2023,F,1,1,37,55,92
327,Moldova,Eurasia,2023,PF,3,3,27,35,62
328,Monaco,Europe,2023,F,3,1,27,57,84
329,Mongolia,Asia,2023,F,1,2,36,48,84
330,Montenegro,Europe,2023,PF,3,3,26,41,67
331,Morocco,Africa,2023,PF,5,5,13,24,37
332,Mozambique,Africa,2023,PF,5,4,14,31,45
333,Myanmar,Asia,2023,NF,7,6,0,9,9
334,Nagorno-Karabakh,Eurasia,2023,PF,5,5,17,20,37
335,Namibia,Africa,2023,F,2,2,31,46,77
336,Nauru,Asia,2023,F,2,3,34,43,77
337,Nepal,Asia,2023,PF,3,4,26,32,58
338,Netherlands,Europe,2023,F,1,1,39,58,97
339,New Zealand,Asia,2023,F,1,1,40,59,99
340,Nicaragua,Americas,2023,NF,7,6,5,14,19
341,Niger,Africa,2023,PF,4,4,23,28,51
342,Nigeria,Africa,2023,PF,4,5,20,23,43
343,North Korea,Asia,2023,NF,7,7,0,3,3
344,North Macedonia,Europe,2023,PF,3,3,29,39,68
345,Northern Cyprus,Europe,2023,F,3,2,27,49,76
346,Norway,Europe,2023,F,1,1,40,60,100
347,Oman,Middle East,2023,NF,6,5,6,18,24
348,Pakistan,Asia,2023,PF,5,5,15,22,37
349,Pakistani Kashmir,Asia,2023,NF,6,5,9,20,29
350,Palau,Asia,2023,F,1,1,37,55,92
351,Panama,Americas,2023,F,2,2,35,48,83
352,Papua New Guinea,Asia,2023,PF,4,3,22,39,61
353,Paraguay,Americas,2023,PF,3,3,28,37,65
354,Peru,Americas,2023,PF,3,3,29,41,70
355,Philippines,Asia,2023,PF,3,4,25,33,58
356,Poland,Europe,2023,F,2,2,34,47,81
357,Portugal,Europe,2023,F,1,1,39,57,96
358,Qatar,Middle East,2023,NF,6,5,7,18,25
359,Romania,Europe,2023,F,2,2,35,48,83
360,Russia,Eurasia,2023,NF,7,6,5,11,16
361,Rwanda,Africa,2023,NF,6,6,8,15,23
362,Samoa,Asia,2023,F,2,2,31,52,83
363,San Marino,Europe,2023,F,1,1,39,58,97
364,Sao Tome and Principe,Africa,2023,F,2,2,35,49,84
365,Saudi Arabia,Middle East,2023,NF,7,7,1,7,8
366,Senegal,Africa,2023,PF,3,3,29,39,68
367,Serbia,Europe,2023,PF,4,3,20,40,60
368,Seychelles,Africa,2023,F,2,2,34,45,79
369,Sierra Leone,Africa,2023,PF,3,3,27,36,63
370,Singapore,Asia,2023,PF,4,4,19,28,47
371,Slovakia,Europe,2023,F,1,1,37,53,90
372,Slovenia,Europe,2023,F,1,1,39,56,95
373,Solomon Islands,Asia,2023,F,3,2,29,47,76
374,Somalia,Africa,2023,NF,7,7,2,6,8
375,Somaliland,Africa,2023,PF,4,4,18,26,44
376,South Africa,Africa,2023,F,2,2,33,46,79
377,South Korea,Asia,2023,F,2,2,33,50,83
378,South Ossetia,Eurasia,2023,NF,7,6,3,9,12
379,South Sudan,Africa,2023,NF,7,7,-3,4,1
380,Spain,Europe,2023,F,1,1,37,53,90
381,Sri Lanka,Asia,2023,PF,4,4,23,31,54
382,St. Kitts and Nevis,Americas,2023,F,2,1,35,54,89
383,St. Lucia,Americas,2023,F,1,1,38,54,92
384,St. Vincent and the Grenadines,Americas,2023,F,1,1,36,55,91
385,Sudan,Africa,2023,NF,7,6,0,10,10
386,Suriname,Americas,2023,F,2,2,34,45,79
387,Sweden,Europe,2023,F,1,1,40,60,100
388,Switzerland,Europe,2023,F,1,1,39,57,96
389,Syria,Middle East,2023,NF,7,7,-3,4,1
390,Taiwan,Asia,2023,F,1,1,38,56,94
391,Tajikistan,Eurasia,2023,NF,7,7,0,7,7
392,Tanzania,Africa,2023,PF,5,5,12,24,36
393,Thailand,Asia,2023,NF,6,5,6,24,30
394,The Gambia,Africa,2023,PF,4,4,21,27,48
395,Tibet,Asia,2023,NF,7,7,-2,3,1
396,Timor-Leste,Asia,2023,F,2,3,33,39,72
397,Togo,Africa,2023,PF,5,4,15,27,42
398,Tonga,Asia,2023,F,2,2,31,50,81
399,Transnistria,Eurasia,2023,NF,6,6,6,12,18
400,Trinidad and Tobago,Americas,2023,F,2,2,33,49,82
401,Tunisia,Africa,2023,PF,4,3,20,36,56
402,Turkey,Europe,2023,NF,5,6,16,16,32
403,Turkmenistan,Eurasia,2023,NF,7,7,0,2,2
404,Tuvalu,Asia,2023,F,1,1,37,56,93
405,Uganda,Africa,2023,NF,6,5,11,24,35
406,Ukraine,Eurasia,2023,PF,4,4,22,28,50
407,United Arab Emirates,Middle East,2023,NF,7,6,5,13,18
408,United Kingdom,Europe,2023,F,1,1,39,54,93
409,United States,Americas,2023,F,2,2,33,50,83
410,Uruguay,Americas,2023,F,1,1,40,56,96
411,Uzbekistan,Eurasia,2023,NF,7,6,2,10,12
412,Vanuatu,Asia,2023,F,2,2,33,49,82
413,Venezuela,Americas,2023,NF,7,6,1,14,15
414,Vietnam,Asia,2023,NF,7,6,4,15,19
415,West Bank,Middle East,2023,NF,7,5,4,18,22
416,Western Sahara,Africa,2023,NF,7,7,-3,7,4
417,Yemen,Middle East,2023,NF,7,6,1,8,9
418,Zambia,Africa,2023,PF,4,4,23,31,54
419,Zimbabwe,Africa,2023,NF,6,5,11,17,28
420,Abkhazia,Eurasia,2022,PF,5,5,17,23,40
421,Afghanistan,Asia,2022,NF,7,6,1,9,10
422,Albania,Europe,2022,PF,3,3,28,39,67
423,Algeria,Africa,2022,NF,6,5,10,22,32
424,Andorra,Europe,2022,F,1,1,38,55,93
425,Angola,Africa,2022,NF,6,5,10,20,30
426,Antigua and Barbuda,Americas,2022,F,2,2,33,52,85
427,Argentina,Americas,2022,F,2,2,35,49,84
428,Armenia,Eurasia,2022,PF,4,4,23,32,55
429,Australia,Asia,2022,F,1,1,39,56,95
430,Austria,Europe,2022,F,1,1,37,56,93
431,Azerbaijan,Eurasia,2022,NF,7,7,2,7,9
432,Bahamas,Americas,2022,F,1,1,38,53,91
433,Bahrain,Middle East,2022,NF,7,6,2,10,12
434,Bangladesh,Asia,2022,PF,5,5,15,24,39
435,Barbados,Americas,2022,F,1,1,38,57,95
436,Belarus,Eurasia,2022,NF,7,7,2,6,8
437,Belgium,Europe,2022,F,1,1,39,57,96
438,Belize,Americas,2022,F,2,1,34,53,87
439,Benin,Africa,2022,PF,5,3,17,42,59
440,Bhutan,Asia,2022,PF,3,4,29,32,61
441,Bolivia,Americas,2022,PF,3,3,27,39,66
442,Bosnia and Herzegovina,Europe,2022,PF,4,4,19,34,53
443,Botswana,Africa,2022,F,3,2,28,44,72
444,Brazil,Americas,2022,F,2,3,31,42,73
445,Brunei,Asia,2022,NF,6,5,7,21,28
446,Bulgaria,Europe,2022,F,2,2,33,46,79
447,Burkina Faso,Africa,2022,PF,4,4,23,30,53
448,Burundi,Africa,2022,NF,7,6,4,10,14
449,Cabo Verde,Africa,2022,F,1,1,38,54,92
450,Cambodia,Asia,2022,NF,7,5,5,19,24
451,Cameroon,Africa,2022,NF,6,6,6,9,15
452,Canada,Americas,2022,F,1,1,40,58,98
453,Central African Republic,Africa,2022,NF,7,7,3,4,7
454,Chad,Africa,2022,NF,7,6,1,14,15
455,Chile,Americas,2022,F,1,1,38,56,94
456,China,Asia,2022,NF,7,6,-2,11,9
457,Colombia,Americas,2022,PF,3,3,29,35,64
458,Comoros,Africa,2022,PF,5,4,16,26,42
459,Congo (Brazzaville),Africa,2022,NF,7,6,2,15,17
460,Congo (Kinshasa),Africa,2022,NF,7,6,4,15,19
461,Costa Rica,Americas,2022,F,1,1,38,53,91
462,Cote d'Ivoire,Africa,2022,PF,4,4,19,30,49
463,Crimea,Eurasia,2022,NF,7,6,-2,9,7
464,Croatia,Europe,2022,F,1,2,36,49,85
465,Cuba,Americas,2022,NF,7,6,1,11,12
466,Cyprus,Europe,2022,F,1,1,38,55,93
467,Czech Republic,Europe,2022,F,1,1,36,55,91
468,Denmark,Europe,2022,F,1,1,40,57,97
469,Djibouti,Africa,2022,NF,7,5,5,19,24
470,Dominica,Americas,2022,F,1,1,37,56,93
471,Dominican Republic,Americas,2022,PF,3,3,27,41,68
472,Eastern Donbas,Eurasia,2022,NF,7,7,-1,5,4
473,Ecuador,Americas,2022,F,2,3,31,40,71
474,Egypt,Africa,2022,NF,6,6,6,12,18
475,El Salvador,Americas,2022,PF,3,4,26,33,59
476,Equatorial Guinea,Africa,2022,NF,7,7,0,5,5
477,Eritrea,Africa,2022,NF,7,7,1,2,3
478,Estonia,Europe,2022,F,1,1,38,56,94
479,Eswatini,Africa,2022,NF,7,6,1,16,17
480,Ethiopia,Africa,2022,NF,5,6,12,11,23
481,Fiji,Asia,2022,PF,4,3,23,35,58
482,Finland,Europe,2022,F,1,1,40,60,100
483,France,Europe,2022,F,1,2,38,51,89
484,Gabon,Africa,2022,NF,7,5,3,18,21
485,Gaza Strip,Middle East,2022,NF,7,6,3,8,11
486,Georgia,Eurasia,2022,PF,4,3,22,36,58
487,Germany,Europe,2022,F,1,1,39,55,94
488,Ghana,Africa,2022,F,2,2,35,45,80
489,Greece,Europe,2022,F,1,2,37,50,87
490,Grenada,Americas,2022,F,1,2,37,52,89
491,Guatemala,Americas,2022,PF,4,4,21,30,51
492,Guinea,Africa,2022,NF,6,5,10,24,34
493,Guinea-Bissau,Africa,2022,PF,5,4,17,26,43
494,Guyana,Americas,2022,F,2,3,30,43,73
495,Haiti,Americas,2022,NF,6,5,11,22,33
496,Honduras,Americas,2022,PF,4,4,21,26,47
497,Hong Kong,Asia,2022,PF,6,4,10,33,43
498,Hungary,Europe,2022,PF,3,3,26,43,69
499,Iceland,Europe,2022,F,1,1,37,57,94
500,India,Asia,2022,PF,2,4,33,33,66
501,Indian Kashmir,Asia,2022,NF,6,5,7,20,27
502,Indonesia,Asia,2022,PF,2,4,30,29,59
503,Iran,Middle East,2022,NF,7,6,4,10,14
504,Iraq,Middle East,2022,NF,5,6,16,13,29
505,Ireland,Europe,2022,F,1,1,39,58,97
506,Israel,Middle East,2022,F,2,3,34,42,76
507,Italy,Europe,2022,F,1,1,36,54,90
508,Jamaica,Americas,2022,F,2,2,34,46,80
509,Japan,Asia,2022,F,1,1,40,56,96
510,Jordan,Middle East,2022,NF,6,5,11,22,33
511,Kazakhstan,Eurasia,2022,NF,7,5,5,18,23
512,Kenya,Africa,2022,PF,4,4,19,29,48
513,Kiribati,Asia,2022,F,1,1,37,56,93
514,Kosovo,Europe,2022,PF,3,4,25,31,56
515,Kuwait,Middle East,2022,PF,5,5,14,23,37
516,Kyrgyzstan,Eurasia,2022,NF,7,5,4,23,27
517,Laos,Asia,2022,NF,7,6,2,11,13
518,Latvia,Europe,2022,F,1,2,37,51,88
519,Lebanon,Middle East,2022,PF,5,4,13,29,42
520,Lesotho,Africa,2022,PF,3,3,27,36,63
521,Liberia,Africa,2022,PF,3,4,27,33,60
522,Libya,Africa,2022,NF,7,6,1,8,9
523,Liechtenstein,Europe,2022,F,2,1,33,57,90
524,Lithuania,Europe,2022,F,1,2,38,51,89
525,Luxembourg,Europe,2022,F,1,1,38,59,97
526,Madagascar,Africa,2022,PF,3,4,27,34,61
527,Malawi,Africa,2022,PF,3,3,29,37,66
528,Malaysia,Asia,2022,PF,4,4,20,30,50
529,Maldives,Asia,2022,PF,4,5,19,21,40
530,Mali,Africa,2022,NF,6,5,8,24,32
531,Malta,Europe,2022,F,2,1,35,54,89
532,Marshall Islands,Asia,2022,F,1,1,38,55,93
533,Mauritania,Africa,2022,PF,5,5,14,21,35
534,Mauritius,Africa,2022,F,1,2,36,50,86
535,Mexico,Americas,2022,PF,3,4,27,33,60
536,Micronesia,Asia,2022,F,1,1,37,55,92
537,Moldova,Eurasia,2022,PF,3,3,27,35,62
538,Monaco,Europe,2022,F,3,1,27,57,84
539,Mongolia,Asia,2022,F,1,2,36,48,84
540,Montenegro,Europe,2022,PF,3,3,26,41,67
541,Morocco,Africa,2022,PF,5,5,13,24,37
542,Mozambique,Africa,2022,PF,5,4,14,29,43
543,Myanmar,Asia,2022,NF,7,6,0,9,9
544,Nagorno-Karabakh,Eurasia,2022,PF,5,5,16,20,36
545,Namibia,Africa,2022,F,2,2,31,46,77
546,Nauru,Asia,2022,F,2,3,34,43,77
547,Nepal,Asia,2022,PF,3,4,25,32,57
548,Netherlands,Europe,2022,F,1,1,39,58,97
549,New Zealand,Asia,2022,F,1,1,40,59,99
550,Nicaragua,Americas,2022,NF,7,5,5,18,23
551,Niger,Africa,2022,PF,4,4,23,28,51
552,Nigeria,Africa,2022,PF,4,5,20,23,43
553,North Korea,Asia,2022,NF,7,7,0,3,3
554,North Macedonia,Europe,2022,PF,3,3,28,39,67
555,Northern Cyprus,Europe,2022,F,3,2,27,50,77
556,Norway,Europe,2022,F,1,1,40,60,100
557,Oman,Middle East,2022,NF,6,5,6,18,24
558,Pakistan,Asia,2022,PF,5,5,15,22,37
559,Pakistani Kashmir,Asia,2022,NF,6,5,9,20,29
560,Palau,Asia,2022,F,1,1,37,55,92
561,Panama,Americas,2022,F,2,2,35,48,83
562,Papua New Guinea,Asia,2022,PF,4,3,23,39,62
563,Paraguay,Americas,2022,PF,3,3,28,37,65
564,Peru,Americas,2022,F,2,3,30,42,72
565,Philippines,Asia,2022,PF,3,4,25,30,55
566,Poland,Europe,2022,F,2,2,34,47,81
567,Portugal,Europe,2022,F,1,1,39,56,95
568,Qatar,Middle East,2022,NF,6,5,7,18,25
569,Romania,Europe,2022,F,2,2,35,48,83
570,Russia,Eurasia,2022,NF,7,6,5,14,19
571,Rwanda,Africa,2022,NF,6,6,8,14,22
572,Samoa,Asia,2022,F,2,2,32,51,83
573,San Marino,Europe,2022,F,1,1,38,55,93
574,Sao Tome and Principe,Africa,2022,F,2,2,35,49,84
575,Saudi Arabia,Middle East,2022,NF,7,7,1,6,7
576,Senegal,Africa,2022,PF,3,3,29,39,68
577,Serbia,Europe,2022,PF,4,3,21,41,62
578,Seychelles,Africa,2022,F,2,2,34,45,79
579,Sierra Leone,Africa,2022,PF,3,3,28,37,65
580,Singapore,Asia,2022,PF,4,4,19,28,47
581,Slovakia,Europe,2022,F,1,1,37,53,90
582,Slovenia,Europe,2022,F,1,2,38,52,90
583,Solomon Islands,Asia,2022,F,2,2,30,49,79
584,Somalia,Africa,2022,NF,7,7,1,6,7
585,Somaliland,Africa,2022,PF,4,4,22,27,49
586,South Africa,Africa,2022,F,2,2,33,46,79
587,South Korea,Asia,2022,F,2,2,33,50,83
588,South Ossetia,Eurasia,2022,NF,7,6,2,9,11
589,South Sudan,Africa,2022,NF,7,7,-3,4,1
590,Spain,Europe,2022,F,1,1,37,53,90
591,Sri Lanka,Asia,2022,PF,4,4,23,32,55
592,St. Kitts and Nevis,Americas,2022,F,2,1,35,54,89
593,St. Lucia,Americas,2022,F,1,1,38,54,92
594,St. Vincent and the Grenadines,Americas,2022,F,1,1,36,55,91
595,Sudan,Africa,2022,NF,7,6,0,10,10
596,Suriname,Americas,2022,F,2,2,34,45,79
597,Sweden,Europe,2022,F,1,1,40,60,100
598,Switzerland,Europe,2022,F,1,1,39,57,96
599,Syria,Middle East,2022,NF,7,7,-3,4,1
600,Taiwan,Asia,2022,F,1,1,38,56,94
601,Tajikistan,Eurasia,2022,NF,7,6,0,8,8
602,Tanzania,Africa,2022,PF,5,5,12,22,34
603,Thailand,Asia,2022,NF,7,5,5,24,29
604,The Gambia,Africa,2022,PF,4,4,21,26,47
605,Tibet,Asia,2022,NF,7,7,-2,3,1
606,Timor-Leste,Asia,2022,F,2,3,33,39,72
607,Togo,Africa,2022,PF,5,4,15,27,42
608,Tonga,Asia,2022,F,2,2,30,49,79
609,Transnistria,Eurasia,2022,NF,6,6,6,12,18
610,Trinidad and Tobago,Americas,2022,F,2,2,33,49,82
611,Tunisia,Africa,2022,PF,3,3,26,38,64
612,Turkey,Europe,2022,NF,5,6,16,16,32
613,Turkmenistan,Eurasia,2022,NF,7,7,0,2,2
614,Tuvalu,Asia,2022,F,1,1,37,56,93
615,Uganda,Africa,2022,NF,6,5,11,23,34
616,Ukraine,Eurasia,2022,PF,3,3,26,35,61
617,United Arab Emirates,Middle East,2022,NF,7,6,5,12,17
618,United Kingdom,Europe,2022,F,1,1,39,54,93
619,United States,Americas,2022,F,2,2,32,51,83
620,Uruguay,Americas,2022,F,1,1,40,57,97
621,Uzbekistan,Eurasia,2022,NF,7,6,2,9,11
622,Vanuatu,Asia,2022,F,2,2,33,49,82
623,Venezuela,Americas,2022,NF,7,6,1,13,14
624,Vietnam,Asia,2022,NF,7,6,3,16,19
625,West Bank,Middle East,2022,NF,7,5,4,19,23
626,Western Sahara,Africa,2022,NF,7,7,-3,7,4
627,Yemen,Middle East,2022,NF,7,6,1,8,9
628,Zambia,Africa,2022,PF,4,4,21,30,51
629,Zimbabwe,Africa,2022,NF,6,5,11,17,28
630,Abkhazia,Eurasia,2021,PF,5,5,17,23,40
631,Afghanistan,Asia,2021,NF,5,6,13,14,27
632,Albania,Europe,2021,PF,3,3,27,39,66
633,Algeria,Africa,2021,NF,6,5,10,22,32
634,Andorra,Europe,2021,F,1,1,38,55,93
635,Angola,Africa,2021,NF,6,5,10,21,31
636,Antigua and Barbuda,Americas,2021,F,2,2,33,52,85
637,Argentina,Americas,2021,F,2,2,35,49,84
638,Armenia,Eurasia,2021,PF,4,4,22,33,55
639,Australia,Asia,2021,F,1,1,40,57,97
640,Austria,Europe,2021,F,1,1,37,56,93
641,Azerbaijan,Eurasia,2021,NF,7,6,2,8,10
642,Bahamas,Americas,2021,F,1,1,38,53,91
643,Bahrain,Middle East,2021,NF,7,6,2,10,12
644,Bangladesh,Asia,2021,PF,5,5,15,24,39
645,Barbados,Americas,2021,F,1,1,38,57,95
646,Belarus,Eurasia,2021,NF,7,6,2,9,11
647,Belgium,Europe,2021,F,1,1,39,57,96
648,Belize,Americas,2021,F,2,1,34,53,87
649,Benin,Africa,2021,PF,4,2,21,44,65
650,Bhutan,Asia,2021,PF,2,4,30,31,61
651,Bolivia,Americas,2021,PF,3,3,27,39,66
652,Bosnia and Herzegovina,Europe,2021,PF,4,4,19,34,53
653,Botswana,Africa,2021,F,3,2,28,44,72
654,Brazil,Americas,2021,F,2,3,31,43,74
655,Brunei,Asia,2021,NF,6,5,7,21,28
656,Bulgaria,Europe,2021,F,2,2,33,45,78
657,Burkina Faso,Africa,2021,PF,4,4,23,31,54
658,Burundi,Africa,2021,NF,7,6,4,10,14
659,Cabo Verde,Africa,2021,F,1,1,38,54,92
660,Cambodia,Asia,2021,NF,7,5,5,19,24
661,Cameroon,Africa,2021,NF,6,6,7,9,16
662,Canada,Americas,2021,F,1,1,40,58,98
663,Central African Republic,Africa,2021,NF,7,7,3,6,9
664,Chad,Africa,2021,NF,7,6,3,14,17
665,Chile,Americas,2021,F,1,1,38,55,93
666,China,Asia,2021,NF,7,6,-2,11,9
667,Colombia,Americas,2021,PF,3,3,29,36,65
668,Comoros,Africa,2021,PF,5,4,16,26,42
669,Congo (Brazzaville),Africa,2021,NF,7,5,2,18,20
670,Congo (Kinshasa),Africa,2021,NF,7,6,5,15,20
671,Costa Rica,Americas,2021,F,1,1,38,53,91
672,Cote d'Ivoire,Africa,2021,PF,5,4,16,28,44
673,Crimea,Eurasia,2021,NF,7,6,-2,9,7
674,Croatia,Europe,2021,F,1,2,36,49,85
675,Cuba,Americas,2021,NF,7,6,1,12,13
676,Cyprus,Europe,2021,F,1,1,38,56,94
677,Czech Republic,Europe,2021,F,1,1,36,55,91
678,Denmark,Europe,2021,F,1,1,40,57,97
679,Djibouti,Africa,2021,NF,7,5,5,19,24
680,Dominica,Americas,2021,F,1,1,37,56,93
681,Dominican Republic,Americas,2021,PF,3,3,26,41,67
682,Eastern Donbas,Eurasia,2021,NF,7,7,-1,5,4
683,Ecuador,Americas,2021,PF,3,3,27,40,67
684,Egypt,Africa,2021,NF,6,6,6,12,18
685,El Salvador,Americas,2021,PF,2,4,30,33,63
686,Equatorial Guinea,Africa,2021,NF,7,7,0,5,5
687,Eritrea,Africa,2021,NF,7,7,1,1,2
688,Estonia,Europe,2021,F,1,1,38,56,94
689,Eswatini,Africa,2021,NF,7,5,1,18,19
690,Ethiopia,Africa,2021,NF,6,6,9,13,22
691,Fiji,Asia,2021,PF,3,3,24,36,60
692,Finland,Europe,2021,F,1,1,40,60,100
693,France,Europe,2021,F,1,2,38,52,90
694,Gabon,Africa,2021,NF,7,5,3,19,22
695,Gaza Strip,Middle East,2021,NF,7,6,3,8,11
696,Georgia,Eurasia,2021,PF,4,3,23,37,60
697,Germany,Europe,2021,F,1,1,39,55,94
698,Ghana,Africa,2021,F,2,2,35,47,82
699,Greece,Europe,2021,F,1,2,37,50,87
700,Grenada,Americas,2021,F,1,2,37,52,89
701,Guatemala,Americas,2021,PF,4,4,21,31,52
702,Guinea,Africa,2021,PF,5,5,14,24,38
703,Guinea-Bissau,Africa,2021,PF,5,4,17,27,44
704,Guyana,Americas,2021,F,2,3,30,43,73
705,Haiti,Americas,2021,PF,5,5,15,22,37
706,Honduras,Americas,2021,PF,4,5,19,25,44
707,Hong Kong,Asia,2021,PF,5,3,15,37,52
708,Hungary,Europe,2021,PF,3,3,26,43,69
709,Iceland,Europe,2021,F,1,1,37,57,94
710,India,Asia,2021,PF,2,4,34,33,67
711,Indian Kashmir,Asia,2021,NF,6,5,7,20,27
712,Indonesia,Asia,2021,PF,2,4,30,29,59
713,Iran,Middle East,2021,NF,6,6,6,10,16
714,Iraq,Middle East,2021,NF,5,6,16,13,29
715,Ireland,Europe,2021,F,1,1,39,58,97
716,Israel,Middle East,2021,F,2,3,33,43,76
717,Italy,Europe,2021,F,1,1,36,54,90
718,Jamaica,Americas,2021,F,2,2,34,46,80
719,Japan,Asia,2021,F,1,1,40,56,96
720,Jordan,Middle East,2021,NF,6,5,11,23,34
721,Kazakhstan,Eurasia,2021,NF,7,5,5,18,23
722,Kenya,Africa,2021,PF,4,4,19,29,48
723,Kiribati,Asia,2021,F,1,1,37,56,93
724,Kosovo,Europe,2021,PF,4,4,23,31,54
725,Kuwait,Middle East,2021,PF,5,5,14,23,37
726,Kyrgyzstan,Eurasia,2021,NF,7,5,4,24,28
727,Laos,Asia,2021,NF,7,6,2,11,13
728,Latvia,Europe,2021,F,1,2,37,52,89
729,Lebanon,Middle East,2021,PF,5,4,13,30,43
730,Lesotho,Africa,2021,PF,3,3,27,36,63
731,Liberia,Africa,2021,PF,3,4,27,33,60
732,Libya,Africa,2021,NF,7,6,1,8,9
733,Liechtenstein,Europe,2021,F,2,1,33,57,90
734,Lithuania,Europe,2021,F,1,2,38,52,90
735,Luxembourg,Europe,2021,F,1,1,38,59,97
736,Madagascar,Africa,2021,PF,3,4,27,33,60
737,Malawi,Africa,2021,PF,3,3,29,37,66
738,Malaysia,Asia,2021,PF,4,4,21,30,51
739,Maldives,Asia,2021,PF,4,5,19,21,40
740,Mali,Africa,2021,NF,6,5,9,24,33
741,Malta,Europe,2021,F,2,1,35,55,90
742,Marshall Islands,Asia,2021,F,1,1,38,55,93
743,Mauritania,Africa,2021,PF,5,5,14,21,35
744,Mauritius,Africa,2021,F,1,2,37,50,87
745,Mexico,Americas,2021,PF,3,4,27,34,61
746,Micronesia,Asia,2021,F,1,1,37,55,92
747,Moldova,Eurasia,2021,PF,3,3,26,35,61
748,Monaco,Europe,2021,F,3,1,26,57,83
749,Mongolia,Asia,2021,F,1,2,36,48,84
750,Montenegro,Europe,2021,PF,3,3,24,39,63
751,Morocco,Africa,2021,PF,5,5,13,24,37
752,Mozambique,Africa,2021,PF,5,4,14,29,43
753,Myanmar,Asia,2021,NF,5,6,13,15,28
754,Nagorno-Karabakh,Eurasia,2021,PF,5,5,16,19,35
755,Namibia,Africa,2021,F,2,2,31,46,77
756,Nauru,Asia,2021,F,2,3,34,43,77
757,Nepal,Asia,2021,PF,3,4,25,31,56
758,Netherlands,Europe,2021,F,1,1,40,58,98
759,New Zealand,Asia,2021,F,1,1,40,59,99
760,Nicaragua,Americas,2021,NF,6,5,10,20,30
761,Niger,Africa,2021,PF,4,4,20,28,48
762,Nigeria,Africa,2021,PF,4,5,21,24,45
763,North Korea,Asia,2021,NF,7,7,0,3,3
764,North Macedonia,Europe,2021,PF,3,3,27,39,66
765,Northern Cyprus,Europe,2021,F,3,2,28,50,78
766,Norway,Europe,2021,F,1,1,40,60,100
767,Oman,Middle East,2021,NF,6,5,6,17,23
768,Pakistan,Asia,2021,PF,5,5,15,22,37
769,Pakistani Kashmir,Asia,2021,NF,6,5,9,19,28
770,Palau,Asia,2021,F,1,1,37,55,92
771,Panama,Americas,2021,F,2,2,35,48,83
772,Papua New Guinea,Asia,2021,PF,4,3,23,39,62
773,Paraguay,Americas,2021,PF,3,3,28,37,65
774,Peru,Americas,2021,PF,3,3,29,42,71
775,Philippines,Asia,2021,PF,3,4,25,31,56
776,Poland,Europe,2021,F,2,2,34,48,82
777,Portugal,Europe,2021,F,1,1,39,57,96
778,Qatar,Middle East,2021,NF,6,5,7,18,25
779,Romania,Europe,2021,F,2,2,35,48,83
780,Russia,Eurasia,2021,NF,7,6,5,15,20
781,Rwanda,Africa,2021,NF,6,6,8,13,21
782,Samoa,Asia,2021,F,2,2,30,51,81
783,San Marino,Europe,2021,F,1,1,38,55,93
784,Sao Tome and Principe,Africa,2021,F,2,2,35,49,84
785,Saudi Arabia,Middle East,2021,NF,7,7,1,6,7
786,Senegal,Africa,2021,PF,3,3,29,42,71
787,Serbia,Europe,2021,PF,4,3,22,42,64
788,Seychelles,Africa,2021,F,2,3,34,43,77
789,Sierra Leone,Africa,2021,PF,3,3,28,37,65
790,Singapore,Asia,2021,PF,4,4,19,29,48
791,Slovakia,Europe,2021,F,1,1,37,53,90
792,Slovenia,Europe,2021,F,1,1,39,56,95
793,Solomon Islands,Asia,2021,F,2,2,30,49,79
794,Somalia,Africa,2021,NF,7,7,1,6,7
795,Somaliland,Africa,2021,PF,4,5,18,24,42
796,South Africa,Africa,2021,F,2,2,33,46,79
797,South Korea,Asia,2021,F,2,2,33,50,83
798,South Ossetia,Eurasia,2021,NF,7,6,2,8,10
799,South Sudan,Africa,2021,NF,7,7,-2,4,2
800,Spain,Europe,2021,F,1,1,37,53,90
801,Sri Lanka,Asia,2021,PF,4,4,23,33,56
802,St. Kitts and Nevis,Americas,2021,F,2,1,35,54,89
803,St. Lucia,Americas,2021,F,1,1,37,54,91
804,St. Vincent and the Grenadines,Americas,2021,F,1,1,36,55,91
805,Sudan,Africa,2021,NF,7,6,2,15,17
806,Suriname,Americas,2021,F,2,2,34,45,79
807,Sweden,Europe,2021,F,1,1,40,60,100
808,Switzerland,Europe,2021,F,1,1,39,57,96
809,Syria,Middle East,2021,NF,7,7,-3,4,1
810,Taiwan,Asia,2021,F,1,1,38,56,94
811,Tajikistan,Eurasia,2021,NF,7,6,0,8,8
812,Tanzania,Africa,2021,PF,5,5,12,22,34
813,Thailand,Asia,2021,NF,7,5,5,25,30
814,The Gambia,Africa,2021,PF,4,4,20,26,46
815,Tibet,Asia,2021,NF,7,7,-2,3,1
816,Timor-Leste,Asia,2021,F,2,3,33,39,72
817,Togo,Africa,2021,PF,5,4,15,28,43
818,Tonga,Asia,2021,F,2,2,30,49,79
819,Transnistria,Eurasia,2021,NF,6,6,8,12,20
820,Trinidad and Tobago,Americas,2021,F,2,2,33,49,82
821,Tunisia,Africa,2021,F,2,3,32,39,71
822,Turkey,Europe,2021,NF,5,6,16,16,32
823,Turkmenistan,Eurasia,2021,NF,7,7,0,2,2
824,Tuvalu,Asia,2021,F,1,1,37,56,93
825,Uganda,Africa,2021,NF,6,5,11,23,34
826,Ukraine,Eurasia,2021,PF,3,4,26,34,60
827,United Arab Emirates,Middle East,2021,NF,7,6,5,12,17
828,United Kingdom,Europe,2021,F,1,1,39,54,93
829,United States,Americas,2021,F,2,2,32,51,83
830,Uruguay,Americas,2021,F,1,1,40,58,98
831,Uzbekistan,Eurasia,2021,NF,7,6,2,9,11
832,Vanuatu,Asia,2021,F,2,2,33,49,82
833,Venezuela,Americas,2021,NF,7,6,1,13,14
834,Vietnam,Asia,2021,NF,7,6,3,16,19
835,West Bank,Middle East,2021,NF,7,5,4,21,25
836,Western Sahara,Africa,2021,NF,7,7,-3,7,4
837,Yemen,Middle East,2021,NF,7,6,1,10,11
838,Zambia,Africa,2021,PF,4,4,20,32,52
839,Zimbabwe,Africa,2021,NF,6,5,11,17,28
840,Abkhazia,Eurasia,2020,PF,5,5,17,23,40
841,Afghanistan,Asia,2020,NF,5,6,13,14,27
842,Albania,Europe,2020,PF,3,3,27,40,67
843,Algeria,Africa,2020,NF,6,5,10,24,34
844,Andorra,Europe,2020,F,1,1,39,55,94
845,Angola,Africa,2020,NF,6,5,11,21,32
846,Antigua and Barbuda,Americas,2020,F,2,2,33,52,85
847,Argentina,Americas,2020,F,2,2,35,50,85
848,Armenia,Eurasia,2020,PF,4,4,21,32,53
849,Australia,Asia,2020,F,1,1,40,57,97
850,Austria,Europe,2020,F,1,1,37,56,93
851,Azerbaijan,Eurasia,2020,NF,7,6,2,8,10
852,Bahamas,Americas,2020,F,1,1,38,53,91
853,Bahrain,Middle East,2020,NF,7,6,1,10,11
854,Bangladesh,Asia,2020,PF,5,5,15,24,39
855,Barbados,Americas,2020,F,1,1,38,57,95
856,Belarus,Eurasia,2020,NF,7,6,5,14,19
857,Belgium,Europe,2020,F,1,1,39,57,96
858,Belize,Americas,2020,F,2,2,35,51,86
859,Benin,Africa,2020,PF,4,2,21,45,66
860,Bhutan,Asia,2020,PF,3,4,29,30,59
861,Bolivia,Americas,2020,PF,3,3,25,38,63
862,Bosnia and Herzegovina,Europe,2020,PF,4,4,19,34,53
863,Botswana,Africa,2020,F,3,2,28,44,72
864,Brazil,Americas,2020,F,2,2,31,44,75
865,Brunei,Asia,2020,NF,6,5,7,21,28
866,Bulgaria,Europe,2020,F,2,2,34,46,80
867,Burkina Faso,Africa,2020,PF,4,4,23,33,56
868,Burundi,Africa,2020,NF,7,6,3,10,13
869,Cabo Verde,Africa,2020,F,1,1,38,54,92
870,Cambodia,Asia,2020,NF,7,5,5,20,25
871,Cameroon,Africa,2020,NF,6,6,7,11,18
872,Canada,Americas,2020,F,1,1,40,58,98
873,Central African Republic,Africa,2020,NF,7,7,4,6,10
874,Chad,Africa,2020,NF,7,6,3,14,17
875,Chile,Americas,2020,F,1,2,38,52,90
876,China,Asia,2020,NF,7,6,-1,11,10
877,Colombia,Americas,2020,PF,3,3,29,37,66
878,Comoros,Africa,2020,PF,4,4,18,26,44
879,Congo (Brazzaville),Africa,2020,NF,7,5,2,18,20
880,Congo (Kinshasa),Africa,2020,NF,7,6,4,14,18
881,Costa Rica,Americas,2020,F,1,1,38,53,91
882,Cote d'Ivoire,Africa,2020,PF,4,4,19,32,51
883,Crimea,Eurasia,2020,NF,7,6,-2,10,8
884,Croatia,Europe,2020,F,1,2,36,49,85
885,Cuba,Americas,2020,NF,7,6,1,13,14
886,Cyprus,Europe,2020,F,1,1,38,56,94
887,Czech Republic,Europe,2020,F,1,1,36,55,91
888,Denmark,Europe,2020,F,1,1,40,57,97
889,Djibouti,Africa,2020,NF,7,5,5,19,24
890,Dominica,Americas,2020,F,1,1,37,56,93
891,Dominican Republic,Americas,2020,PF,3,3,26,41,67
892,Eastern Donbas,Eurasia,2020,NF,7,7,-1,6,5
893,Ecuador,Americas,2020,PF,3,3,27,38,65
894,Egypt,Africa,2020,NF,6,6,7,14,21
895,El Salvador,Americas,2020,PF,2,4,32,34,66
896,Equatorial Guinea,Africa,2020,NF,7,7,0,6,6
897,Eritrea,Africa,2020,NF,7,7,1,1,2
898,Estonia,Europe,2020,F,1,1,38,56,94
899,Eswatini,Africa,2020,NF,7,5,1,18,19
900,Ethiopia,Africa,2020,NF,6,6,10,14,24
901,Fiji,Asia,2020,PF,3,3,24,36,60
902,Finland,Europe,2020,F,1,1,40,60,100
903,France,Europe,2020,F,1,2,38,52,90
904,Gabon,Africa,2020,NF,7,5,3,19,22
905,Gaza Strip,Middle East,2020,NF,7,6,3,8,11
906,Georgia,Eurasia,2020,PF,3,3,24,37,61
907,Germany,Europe,2020,F,1,1,39,55,94
908,Ghana,Africa,2020,F,2,2,35,47,82
909,Greece,Europe,2020,F,1,2,37,51,88
910,Grenada,Americas,2020,F,1,2,37,52,89
911,Guatemala,Americas,2020,PF,4,4,21,31,52
912,Guinea,Africa,2020,PF,5,5,15,25,40
913,Guinea-Bissau,Africa,2020,PF,5,4,17,29,46
914,Guyana,Americas,2020,F,2,3,31,43,74
915,Haiti,Americas,2020,PF,5,5,16,22,38
916,Honduras,Americas,2020,PF,4,4,19,26,45
917,Hong Kong,Asia,2020,PF,5,3,16,39,55
918,Hungary,Europe,2020,PF,3,3,27,43,70
919,Iceland,Europe,2020,F,1,1,37,57,94
920,India,Asia,2020,F,2,3,34,37,71
921,Indian Kashmir,Asia,2020,NF,6,5,8,20,28
922,Indonesia,Asia,2020,PF,2,4,30,31,61
923,Iran,Middle East,2020,NF,6,6,7,10,17
924,Iraq,Middle East,2020,NF,5,6,17,14,31
925,Ireland,Europe,2020,F,1,1,39,58,97
926,Israel,Middle East,2020,F,2,3,33,43,76
927,Italy,Europe,2020,F,1,1,36,53,89
928,Jamaica,Americas,2020,F,2,2,34,44,78
929,Japan,Asia,2020,F,1,1,40,56,96
930,Jordan,Middle East,2020,PF,5,5,12,25,37
931,Kazakhstan,Eurasia,2020,NF,7,5,5,18,23
932,Kenya,Africa,2020,PF,4,4,19,29,48
933,Kiribati,Asia,2020,F,1,1,37,56,93
934,Kosovo,Europe,2020,PF,3,4,25,31,56
935,Kuwait,Middle East,2020,PF,5,5,13,23,36
936,Kyrgyzstan,Eurasia,2020,PF,5,4,12,27,39
937,Laos,Asia,2020,NF,7,6,2,12,14
938,Latvia,Europe,2020,F,1,2,37,52,89
939,Lebanon,Middle East,2020,PF,5,4,14,30,44
940,Lesotho,Africa,2020,PF,3,3,27,36,63
941,Liberia,Africa,2020,PF,3,4,27,33,60
942,Libya,Africa,2020,NF,7,6,1,8,9
943,Liechtenstein,Europe,2020,F,2,1,33,57,90
944,Lithuania,Europe,2020,F,1,1,38,53,91
945,Luxembourg,Europe,2020,F,1,1,38,60,98
946,Madagascar,Africa,2020,PF,3,3,26,35,61
947,Malawi,Africa,2020,PF,3,3,26,36,62
948,Malaysia,Asia,2020,PF,4,4,21,31,52
949,Maldives,Asia,2020,PF,4,5,18,22,40
950,Mali,Africa,2020,PF,5,5,17,24,41
951,Malta,Europe,2020,F,2,1,35,55,90
952,Marshall Islands,Asia,2020,F,1,1,38,55,93
953,Mauritania,Africa,2020,PF,5,5,13,21,34
954,Mauritius,Africa,2020,F,1,2,37,52,89
955,Mexico,Americas,2020,PF,3,3,27,35,62
956,Micronesia,Asia,2020,F,1,1,37,55,92
957,Moldova,Eurasia,2020,PF,3,4,26,34,60
958,Monaco,Europe,2020,F,3,1,26,57,83
959,Mongolia,Asia,2020,F,1,2,36,48,84
960,Montenegro,Europe,2020,PF,4,3,22,40,62
961,Morocco,Africa,2020,PF,5,5,13,24,37
962,Mozambique,Africa,2020,PF,5,4,14,31,45
963,Myanmar,Asia,2020,NF,5,6,14,16,30
964,Nagorno-Karabakh,Eurasia,2020,PF,5,5,13,21,34
965,Namibia,Africa,2020,F,2,2,31,46,77
966,Nauru,Asia,2020,F,2,3,34,43,77
967,Nepal,Asia,2020,PF,3,4,25,31,56
968,Netherlands,Europe,2020,F,1,1,40,59,99
969,New Zealand,Asia,2020,F,1,1,40,57,97
970,Nicaragua,Americas,2020,NF,6,5,10,21,31
971,Niger,Africa,2020,PF,4,4,20,28,48
972,Nigeria,Africa,2020,PF,4,5,22,25,47
973,North Korea,Asia,2020,NF,7,7,0,3,3
974,North Macedonia,Europe,2020,PF,3,3,24,39,63
975,Northern Cyprus,Europe,2020,F,2,2,31,50,81
976,Norway,Europe,2020,F,1,1,40,60,100
977,Oman,Middle East,2020,NF,6,5,6,17,23
978,Pakistan,Asia,2020,PF,5,5,16,22,38
979,Pakistani Kashmir,Asia,2020,NF,6,5,9,19,28
980,Palau,Asia,2020,F,1,1,37,55,92
981,Panama,Americas,2020,F,1,2,36,48,84
982,Papua New Guinea,Asia,2020,PF,4,3,23,39,62
983,Paraguay,Americas,2020,PF,3,3,28,37,65
984,Peru,Americas,2020,F,2,3,30,42,72
985,Philippines,Asia,2020,PF,3,4,25,34,59
986,Poland,Europe,2020,F,2,2,35,49,84
987,Portugal,Europe,2020,F,1,1,39,57,96
988,Qatar,Middle East,2020,NF,6,5,7,18,25
989,Romania,Europe,2020,F,2,2,35,48,83
990,Russia,Eurasia,2020,NF,7,6,5,15,20
991,Rwanda,Africa,2020,NF,6,6,8,14,22
992,Samoa,Asia,2020,F,2,2,30,51,81
993,San Marino,Europe,2020,F,1,1,38,57,95
994,Sao Tome and Principe,Africa,2020,F,2,2,35,49,84
995,Saudi Arabia,Middle East,2020,NF,7,7,1,6,7
996,Senegal,Africa,2020,PF,3,3,29,42,71
997,Serbia,Europe,2020,PF,4,3,23,43,66
998,Seychelles,Africa,2020,PF,3,3,29,43,72
999,Sierra Leone,Africa,2020,PF,3,3,28,37,65
1000,Singapore,Asia,2020,PF,4,4,19,31,50
1001,Slovakia,Europe,2020,F,1,2,36,52,88
1002,Slovenia,Europe,2020,F,1,1,39,55,94
1003,Solomon Islands,Asia,2020,F,2,2,30,49,79
1004,Somalia,Africa,2020,NF,7,7,1,6,7
1005,Somaliland,Africa,2020,PF,5,5,17,24,41
1006,South Africa,Africa,2020,F,2,2,33,46,79
1007,South Korea,Asia,2020,F,2,2,33,50,83
1008,South Ossetia,Eurasia,2020,NF,7,6,2,8,10
1009,South Sudan,Africa,2020,NF,7,7,-2,4,2
1010,Spain,Europe,2020,F,1,1,38,54,92
1011,Sri Lanka,Asia,2020,PF,4,4,23,33,56
1012,St. Kitts and Nevis,Americas,2020,F,1,1,36,53,89
1013,St. Lucia,Americas,2020,F,1,1,38,54,92
1014,St. Vincent and the Grenadines,Americas,2020,F,1,1,36,55,91
1015,Sudan,Africa,2020,NF,7,6,2,10,12
1016,Suriname,Americas,2020,F,2,3,32,43,75
1017,Sweden,Europe,2020,F,1,1,40,60,100
1018,Switzerland,Europe,2020,F,1,1,39,57,96
1019,Syria,Middle East,2020,NF,7,7,-3,3,0
1020,Taiwan,Asia,2020,F,1,1,37,56,93
1021,Tajikistan,Eurasia,2020,NF,7,6,0,9,9
1022,Tanzania,Africa,2020,PF,5,5,17,23,40
1023,Thailand,Asia,2020,PF,6,4,6,26,32
1024,The Gambia,Africa,2020,PF,4,4,20,26,46
1025,Tibet,Asia,2020,NF,7,7,-2,3,1
1026,Timor-Leste,Asia,2020,F,2,3,32,39,71
1027,Togo,Africa,2020,PF,5,4,16,28,44
1028,Tonga,Asia,2020,F,2,2,30,49,79
1029,Transnistria,Eurasia,2020,NF,6,6,9,13,22
1030,Trinidad and Tobago,Americas,2020,F,2,2,33,49,82
1031,Tunisia,Africa,2020,F,2,3,32,38,70
1032,Turkey,Europe,2020,NF,5,6,16,16,32
1033,Turkmenistan,Eurasia,2020,NF,7,7,0,2,2
1034,Tuvalu,Asia,2020,F,1,1,37,56,93
1035,Uganda,Africa,2020,NF,6,5,11,23,34
1036,Ukraine,Eurasia,2020,PF,3,3,27,35,62
1037,United Arab Emirates,Middle East,2020,NF,7,6,5,12,17
1038,United Kingdom,Europe,2020,F,1,1,39,55,94
1039,United States,Americas,2020,F,2,1,33,53,86
1040,Uruguay,Americas,2020,F,1,1,40,58,98
1041,Uzbekistan,Eurasia,2020,NF,7,6,2,8,10
1042,Vanuatu,Asia,2020,F,2,2,33,49,82
1043,Venezuela,Americas,2020,NF,7,6,2,14,16
1044,Vietnam,Asia,2020,NF,7,5,3,17,20
1045,West Bank,Middle East,2020,NF,7,5,4,21,25
1046,Western Sahara,Africa,2020,NF,7,7,-3,7,4
1047,Yemen,Middle East,2020,NF,7,6,1,10,11
1048,Zambia,Africa,2020,PF,4,4,22,32,54
1049,Zimbabwe,Africa,2020,PF,5,5,12,17,29
1050,Abkhazia,Eurasia,2019,PF,4,5,18,23,41
1051,Afghanistan,Asia,2019,NF,5,6,13,14,27
1052,Albania,Europe,2019,PF,3,3,28,40,68
1053,Algeria,Africa,2019,NF,6,5,10,24,34
1054,Andorra,Europe,2019,F,1,1,39,55,94
1055,Angola,Africa,2019,NF,6,5,11,20,31
1056,Antigua and Barbuda,Americas,2019,F,2,2,33,51,84
1057,Argentina,Americas,2019,F,2,2,34,50,84
1058,Armenia,Eurasia,2019,PF,4,4,20,31,51
1059,Australia,Asia,2019,F,1,1,40,58,98
1060,Austria,Europe,2019,F,1,1,37,56,93
1061,Azerbaijan,Eurasia,2019,NF,7,6,2,9,11
1062,Bahamas,Americas,2019,F,1,1,38,53,91
1063,Bahrain,Middle East,2019,NF,7,6,2,10,12
1064,Bangladesh,Asia,2019,PF,5,5,17,24,41
1065,Barbados,Americas,2019,F,1,1,38,58,96
1066,Belarus,Eurasia,2019,NF,7,6,5,14,19
1067,Belgium,Europe,2019,F,1,1,39,57,96
1068,Belize,Americas,2019,F,1,2,36,50,86
1069,Benin,Africa,2019,F,2,2,32,47,79
1070,Bhutan,Asia,2019,PF,3,4,29,30,59
1071,Bolivia,Americas,2019,PF,3,3,28,39,67
1072,Bosnia and Herzegovina,Europe,2019,PF,4,4,19,34,53
1073,Botswana,Africa,2019,F,3,2,28,44,72
1074,Brazil,Americas,2019,F,2,2,30,45,75
1075,Brunei,Asia,2019,NF,6,5,7,22,29
1076,Bulgaria,Europe,2019,F,2,2,33,47,80
1077,Burkina Faso,Africa,2019,PF,4,3,23,37,60
1078,Burundi,Africa,2019,NF,7,6,3,11,14
1079,Cabo Verde,Africa,2019,F,1,1,37,53,90
1080,Cambodia,Asia,2019,NF,6,5,6,20,26
1081,Cameroon,Africa,2019,NF,6,6,7,12,19
1082,Canada,Americas,2019,F,1,1,40,59,99
1083,Central African Republic,Africa,2019,NF,7,7,4,5,9
1084,Chad,Africa,2019,NF,7,6,3,14,17
1085,Chile,Americas,2019,F,1,1,37,57,94
1086,China,Asia,2019,NF,7,6,-1,12,11
1087,Colombia,Americas,2019,PF,3,3,29,37,66
1088,Comoros,Africa,2019,PF,4,4,21,29,50
1089,Congo (Brazzaville),Africa,2019,NF,7,5,2,19,21
1090,Congo (Kinshasa),Africa,2019,NF,7,6,3,12,15
1091,Costa Rica,Americas,2019,F,1,1,38,53,91
1092,Cote d'Ivoire,Africa,2019,PF,4,4,19,32,51
1093,Crimea,Eurasia,2019,NF,7,6,-2,10,8
1094,Croatia,Europe,2019,F,1,2,36,49,85
1095,Cuba,Americas,2019,NF,7,6,1,13,14
1096,Cyprus,Europe,2019,F,1,1,38,56,94
1097,Czech Republic,Europe,2019,F,1,1,36,55,91
1098,Denmark,Europe,2019,F,1,1,40,57,97
1099,Djibouti,Africa,2019,NF,6,5,7,19,26
1100,Dominica,Americas,2019,F,1,1,37,56,93
1101,Dominican Republic,Americas,2019,PF,3,3,26,41,67
1102,Ecuador,Americas,2019,PF,3,3,25,38,63
1103,Egypt,Africa,2019,NF,6,6,8,14,22
1104,El Salvador,Americas,2019,F,2,3,32,35,67
1105,Equatorial Guinea,Africa,2019,NF,7,7,0,6,6
1106,Eritrea,Africa,2019,NF,7,7,1,1,2
1107,Estonia,Europe,2019,F,1,1,38,56,94
1108,Eswatini,Africa,2019,NF,7,6,1,15,16
1109,Ethiopia,Africa,2019,NF,6,6,7,12,19
1110,Fiji,Asia,2019,PF,3,3,24,37,61
1111,Finland,Europe,2019,F,1,1,40,60,100
1112,France,Europe,2019,F,1,2,38,52,90
1113,Gabon,Africa,2019,NF,7,5,4,19,23
1114,Gaza Strip,Middle East,2019,NF,7,6,3,8,11
1115,Georgia,Eurasia,2019,PF,3,3,25,38,63
1116,Germany,Europe,2019,F,1,1,39,55,94
1117,Ghana,Africa,2019,F,1,2,36,47,83
1118,Greece,Europe,2019,F,1,2,36,51,87
1119,Grenada,Americas,2019,F,1,2,37,52,89
1120,Guatemala,Americas,2019,PF,4,4,22,31,53
1121,Guinea,Africa,2019,PF,5,4,17,26,43
1122,Guinea-Bissau,Africa,2019,PF,5,4,15,27,42
1123,Guyana,Americas,2019,F,2,3,32,43,75
1124,Haiti,Americas,2019,PF,5,5,17,24,41
1125,Honduras,Americas,2019,PF,4,4,20,26,46
1126,Hong Kong,Asia,2019,PF,5,2,15,44,59
1127,Hungary,Europe,2019,PF,3,3,27,43,70
1128,Iceland,Europe,2019,F,1,1,37,57,94
1129,India,Asia,2019,F,2,3,35,40,75
1130,Indian Kashmir,Asia,2019,PF,4,4,22,27,49
1131,Indonesia,Asia,2019,PF,2,4,30,32,62
1132,Iran,Middle East,2019,NF,6,6,7,11,18
1133,Iraq,Middle East,2019,NF,5,6,17,15,32
1134,Ireland,Europe,2019,F,1,1,39,58,97
1135,Israel,Middle East,2019,F,2,3,35,43,78
1136,Italy,Europe,2019,F,1,1,36,53,89
1137,Jamaica,Americas,2019,F,2,2,34,44,78
1138,Japan,Asia,2019,F,1,1,40,56,96
1139,Jordan,Middle East,2019,PF,5,5,12,25,37
1140,Kazakhstan,Eurasia,2019,NF,7,5,5,17,22
1141,Kenya,Africa,2019,PF,4,4,19,29,48
1142,Kiribati,Asia,2019,F,1,1,37,56,93
1143,Kosovo,Europe,2019,PF,3,4,24,30,54
1144,Kuwait,Middle East,2019,PF,5,5,13,23,36
1145,Kyrgyzstan,Eurasia,2019,PF,5,4,12,26,38
1146,Laos,Asia,2019,NF,7,6,2,12,14
1147,Latvia,Europe,2019,F,2,2,35,52,87
1148,Lebanon,Middle East,2019,PF,5,4,14,31,45
1149,Lesotho,Africa,2019,PF,3,3,27,36,63
1150,Liberia,Africa,2019,PF,3,3,27,35,62
1151,Libya,Africa,2019,NF,7,6,1,8,9
1152,Liechtenstein,Europe,2019,F,2,1,33,57,90
1153,Lithuania,Europe,2019,F,1,1,38,53,91
1154,Luxembourg,Europe,2019,F,1,1,38,60,98
1155,Madagascar,Africa,2019,PF,3,4,24,32,56
1156,Malawi,Africa,2019,PF,3,3,26,38,64
1157,Malaysia,Asia,2019,PF,4,4,21,31,52
1158,Maldives,Asia,2019,PF,5,5,14,21,35
1159,Mali,Africa,2019,PF,4,4,18,26,44
1160,Malta,Europe,2019,F,2,1,35,56,91
1161,Marshall Islands,Asia,2019,F,1,1,38,55,93
1162,Mauritania,Africa,2019,NF,6,5,11,21,32
1163,Mauritius,Africa,2019,F,1,2,37,52,89
1164,Mexico,Americas,2019,PF,3,3,27,36,63
1165,Micronesia,Asia,2019,F,1,1,37,55,92
1166,Moldova,Eurasia,2019,PF,3,4,24,34,58
1167,Monaco,Europe,2019,F,3,1,26,56,82
1168,Mongolia,Asia,2019,F,1,2,36,49,85
1169,Montenegro,Europe,2019,PF,4,3,23,42,65
1170,Morocco,Africa,2019,PF,5,5,14,25,39
1171,Mozambique,Africa,2019,PF,4,4,19,32,51
1172,Myanmar,Asia,2019,PF,5,5,13,17,30
1173,Nagorno-Karabakh,Eurasia,2019,PF,5,5,12,19,31
1174,Namibia,Africa,2019,F,3,2,29,46,75
1175,Nauru,Asia,2019,F,2,2,34,44,78
1176,Nepal,Asia,2019,PF,3,4,25,29,54
1177,Netherlands,Europe,2019,F,1,1,40,59,99
1178,New Zealand,Asia,2019,F,1,1,40,58,98
1179,Nicaragua,Americas,2019,NF,6,5,10,22,32
1180,Niger,Africa,2019,PF,4,4,20,29,49
1181,Nigeria,Africa,2019,PF,3,5,25,25,50
1182,North Korea,Asia,2019,NF,7,7,0,3,3
1183,North Macedonia,Europe,2019,PF,4,3,22,37,59
1184,Northern Cyprus,Europe,2019,F,2,2,31,50,81
1185,Norway,Europe,2019,F,1,1,40,60,100
1186,Oman,Middle East,2019,NF,6,5,6,17,23
1187,Pakistan,Asia,2019,PF,5,5,17,22,39
1188,Pakistani Kashmir,Asia,2019,NF,6,5,9,19,28
1189,Palau,Asia,2019,F,1,1,37,55,92
1190,Panama,Americas,2019,F,1,2,36,48,84
1191,Papua New Guinea,Asia,2019,PF,4,3,23,41,64
1192,Paraguay,Americas,2019,PF,3,3,28,37,65
1193,Peru,Americas,2019,F,2,3,31,42,73
1194,Philippines,Asia,2019,PF,3,3,26,35,61
1195,Poland,Europe,2019,F,2,2,35,49,84
1196,Portugal,Europe,2019,F,1,1,39,57,96
1197,Qatar,Middle East,2019,NF,6,5,7,18,25
1198,Romania,Europe,2019,F,2,2,34,47,81
1199,Russia,Eurasia,2019,NF,7,6,5,15,20
1200,Rwanda,Africa,2019,NF,6,6,9,14,23
1201,Samoa,Asia,2019,F,2,2,30,51,81
1202,San Marino,Europe,2019,F,1,1,38,57,95
1203,Sao Tome and Principe,Africa,2019,F,2,2,34,49,83
1204,Saudi Arabia,Middle East,2019,NF,7,7,1,6,7
1205,Senegal,Africa,2019,F,2,3,30,42,72
1206,Serbia,Europe,2019,PF,3,3,24,43,67
1207,Seychelles,Africa,2019,PF,3,3,28,43,71
1208,Sierra Leone,Africa,2019,PF,3,3,28,37,65
1209,Singapore,Asia,2019,PF,4,4,19,32,51
1210,Slovakia,Europe,2019,F,1,2,36,52,88
1211,Slovenia,Europe,2019,F,1,1,39,55,94
1212,Solomon Islands,Asia,2019,F,2,2,30,49,79
1213,Somalia,Africa,2019,NF,7,7,1,6,7
1214,Somaliland,Africa,2019,PF,4,5,19,24,43
1215,South Africa,Africa,2019,F,2,2,33,46,79
1216,South Korea,Asia,2019,F,2,2,33,50,83
1217,South Ossetia,Eurasia,2019,NF,7,6,2,8,10
1218,South Sudan,Africa,2019,NF,7,7,-2,4,2
1219,Spain,Europe,2019,F,1,1,39,55,94
1220,Sri Lanka,Asia,2019,PF,3,4,24,32,56
1221,St. Kitts and Nevis,Americas,2019,F,1,1,36,53,89
1222,St. Lucia,Americas,2019,F,1,1,38,54,92
1223,St. Vincent and the Grenadines,Americas,2019,F,1,1,36,55,91
1224,Sudan,Africa,2019,NF,7,7,3,4,7
1225,Suriname,Americas,2019,F,2,3,34,43,77
1226,Sweden,Europe,2019,F,1,1,40,60,100
1227,Switzerland,Europe,2019,F,1,1,39,57,96
1228,Syria,Middle East,2019,NF,7,7,-3,3,0
1229,Taiwan,Asia,2019,F,1,1,37,56,93
1230,Tajikistan,Eurasia,2019,NF,7,6,0,9,9
1231,Tanzania,Africa,2019,PF,4,5,20,25,45
1232,Thailand,Asia,2019,NF,7,5,5,25,30
1233,The Gambia,Africa,2019,PF,4,5,20,25,45
1234,Tibet,Asia,2019,NF,7,7,-2,3,1
1235,Timor-Leste,Asia,2019,F,2,3,32,38,70
1236,Togo,Africa,2019,PF,5,4,15,28,43
1237,Tonga,Asia,2019,F,2,2,30,49,79
1238,Transnistria,Eurasia,2019,NF,6,6,10,14,24
1239,Trinidad and Tobago,Americas,2019,F,2,2,33,49,82
1240,Tunisia,Africa,2019,F,2,3,31,38,69
1241,Turkey,Europe,2019,NF,5,6,15,16,31
1242,Turkmenistan,Eurasia,2019,NF,7,7,0,2,2
1243,Tuvalu,Asia,2019,F,1,1,37,56,93
1244,Uganda,Africa,2019,NF,6,5,11,25,36
1245,Ukraine,Eurasia,2019,PF,3,4,26,34,60
1246,United Arab Emirates,Middle East,2019,NF,7,6,5,12,17
1247,United Kingdom,Europe,2019,F,1,1,39,54,93
1248,United States,Americas,2019,F,2,1,33,53,86
1249,Uruguay,Americas,2019,F,1,1,40,58,98
1250,Uzbekistan,Eurasia,2019,NF,7,6,1,8,9
1251,Vanuatu,Asia,2019,F,2,2,33,49,82
1252,Venezuela,Americas,2019,NF,7,6,3,16,19
1253,Vietnam,Asia,2019,NF,7,5,3,17,20
1254,West Bank,Middle East,2019,NF,7,5,4,21,25
1255,Western Sahara,Africa,2019,NF,7,7,-3,7,4
1256,Yemen,Middle East,2019,NF,7,6,1,10,11
1257,Zambia,Africa,2019,PF,4,4,22,32,54
1258,Zimbabwe,Africa,2019,PF,5,5,12,19,31
1259,Abkhazia,Eurasia,2018,PF,4,5,18,23,41
1260,Afghanistan,Asia,2018,NF,5,6,12,14,26
1261,Albania,Europe,2018,PF,3,3,28,40,68
1262,Algeria,Africa,2018,NF,6,5,10,25,35
1263,Andorra,Europe,2018,F,1,1,39,57,96
1264,Angola,Africa,2018,NF,6,6,10,16,26
1265,Antigua and Barbuda,Americas,2018,F,2,2,33,50,83
1266,Argentina,Americas,2018,F,2,2,33,50,83
1267,Armenia,Eurasia,2018,PF,5,4,15,30,45
1268,Australia,Asia,2018,F,1,1,40,58,98
1269,Austria,Europe,2018,F,1,1,37,57,94
1270,Azerbaijan,Eurasia,2018,NF,7,6,3,9,12
1271,Bahamas,Americas,2018,F,1,1,38,53,91
1272,Bahrain,Middle East,2018,NF,7,6,2,10,12
1273,Bangladesh,Asia,2018,PF,4,4,19,26,45
1274,Barbados,Americas,2018,F,1,1,38,58,96
1275,Belarus,Eurasia,2018,NF,6,6,6,15,21
1276,Belgium,Europe,2018,F,1,1,39,56,95
1277,Belize,Americas,2018,F,1,2,36,50,86
1278,Benin,Africa,2018,F,2,2,33,49,82
1279,Bhutan,Asia,2018,PF,3,4,28,27,55
1280,Bolivia,Americas,2018,PF,3,3,28,39,67
1281,Bosnia and Herzegovina,Europe,2018,PF,4,4,21,34,55
1282,Botswana,Africa,2018,F,3,2,28,44,72
1283,Brazil,Americas,2018,F,2,2,31,47,78
1284,Brunei,Asia,2018,NF,6,5,6,22,28
1285,Bulgaria,Europe,2018,F,2,2,33,47,80
1286,Burkina Faso,Africa,2018,PF,4,3,23,37,60
1287,Burundi,Africa,2018,NF,7,6,4,14,18
1288,Cabo Verde,Africa,2018,F,1,1,37,53,90
1289,Cambodia,Asia,2018,NF,6,5,10,20,30
1290,Cameroon,Africa,2018,NF,6,6,9,13,22
1291,Canada,Americas,2018,F,1,1,40,59,99
1292,Central African Republic,Africa,2018,NF,7,7,4,5,9
1293,Chad,Africa,2018,NF,7,6,4,14,18
1294,Chile,Americas,2018,F,1,1,37,57,94
1295,China,Asia,2018,NF,7,6,0,14,14
1296,Colombia,Americas,2018,PF,3,3,29,36,65
1297,Comoros,Africa,2018,PF,3,4,24,31,55
1298,Congo (Brazzaville),Africa,2018,NF,7,5,2,19,21
1299,Congo (Kinshasa),Africa,2018,NF,7,6,4,13,17
1300,Costa Rica,Americas,2018,F,1,1,38,53,91
1301,Cote d'Ivoire,Africa,2018,PF,4,4,19,32,51
1302,Crimea,Eurasia,2018,NF,7,6,-1,10,9
1303,Croatia,Europe,2018,F,1,2,37,49,86
1304,Cuba,Americas,2018,NF,7,6,1,13,14
1305,Cyprus,Europe,2018,F,1,1,38,56,94
1306,Czech Republic,Europe,2018,F,1,1,37,56,93
1307,Denmark,Europe,2018,F,1,1,40,57,97
1308,Djibouti,Africa,2018,NF,6,5,7,19,26
1309,Dominica,Americas,2018,F,1,1,37,56,93
1310,Dominican Republic,Americas,2018,PF,3,3,26,41,67
1311,Ecuador,Americas,2018,PF,3,3,25,35,60
1312,Egypt,Africa,2018,NF,6,6,10,16,26
1313,El Salvador,Americas,2018,F,2,3,34,36,70
1314,Equatorial Guinea,Africa,2018,NF,7,7,1,6,7
1315,Eritrea,Africa,2018,NF,7,7,1,2,3
1316,Estonia,Europe,2018,F,1,1,38,56,94
1317,Eswatini,Africa,2018,NF,7,6,1,15,16
1318,Ethiopia,Africa,2018,NF,7,6,4,8,12
1319,Fiji,Asia,2018,PF,3,3,24,35,59
1320,Finland,Europe,2018,F,1,1,40,60,100
1321,France,Europe,2018,F,1,2,38,52,90
1322,Gabon,Africa,2018,NF,7,5,4,19,23
1323,Gaza Strip,Middle East,2018,NF,7,6,3,9,12
1324,Georgia,Eurasia,2018,PF,3,3,26,38,64
1325,Germany,Europe,2018,F,1,1,39,55,94
1326,Ghana,Africa,2018,F,1,2,37,46,83
1327,Greece,Europe,2018,F,2,2,35,50,85
1328,Grenada,Americas,2018,F,1,2,37,51,88
1329,Guatemala,Americas,2018,PF,4,4,23,33,56
1330,Guinea,Africa,2018,PF,5,5,17,24,41
1331,Guinea-Bissau,Africa,2018,PF,5,5,16,25,41
1332,Guyana,Americas,2018,F,2,3,32,42,74
1333,Haiti,Americas,2018,PF,5,5,17,24,41
1334,Honduras,Americas,2018,PF,4,4,20,26,46
1335,Hong Kong,Asia,2018,PF,5,2,15,44,59
1336,Hungary,Europe,2018,F,3,2,28,44,72
1337,Iceland,Europe,2018,F,1,1,37,58,95
1338,India,Asia,2018,F,2,3,35,42,77
1339,Indian Kashmir,Asia,2018,PF,4,4,22,27,49
1340,Indonesia,Asia,2018,PF,2,4,30,34,64
1341,Iran,Middle East,2018,NF,6,6,7,11,18
1342,Iraq,Middle East,2018,NF,5,6,16,15,31
1343,Ireland,Europe,2018,F,1,1,39,57,96
1344,Israel,Middle East,2018,F,1,3,36,43,79
1345,Italy,Europe,2018,F,1,1,36,53,89
1346,Jamaica,Americas,2018,F,2,3,34,43,77
1347,Japan,Asia,2018,F,1,1,40,56,96
1348,Jordan,Middle East,2018,PF,5,5,12,25,37
1349,Kazakhstan,Eurasia,2018,NF,7,5,5,17,22
1350,Kenya,Africa,2018,PF,4,4,19,29,48
1351,Kiribati,Asia,2018,F,1,1,38,55,93
1352,Kosovo,Europe,2018,PF,3,4,24,28,52
1353,Kuwait,Middle East,2018,PF,5,5,13,23,36
1354,Kyrgyzstan,Eurasia,2018,PF,5,5,12,25,37
1355,Laos,Asia,2018,NF,7,6,1,11,12
1356,Latvia,Europe,2018,F,2,2,35,52,87
1357,Lebanon,Middle East,2018,PF,6,4,11,32,43
1358,Lesotho,Africa,2018,PF,3,3,27,37,64
1359,Liberia,Africa,2018,PF,3,3,27,35,62
1360,Libya,Africa,2018,NF,7,6,1,8,9
1361,Liechtenstein,Europe,2018,F,2,1,33,57,90
1362,Lithuania,Europe,2018,F,1,1,38,53,91
1363,Luxembourg,Europe,2018,F,1,1,38,60,98
1364,Madagascar,Africa,2018,PF,3,4,24,32,56
1365,Malawi,Africa,2018,PF,3,3,26,37,63
1366,Malaysia,Asia,2018,PF,4,4,18,27,45
1367,Maldives,Asia,2018,PF,5,5,14,21,35
1368,Mali,Africa,2018,PF,5,4,17,27,44
1369,Malta,Europe,2018,F,1,1,36,56,92
1370,Marshall Islands,Asia,2018,F,1,1,37,55,92
1371,Mauritania,Africa,2018,NF,6,5,9,21,30
1372,Mauritius,Africa,2018,F,1,2,37,52,89
1373,Mexico,Americas,2018,PF,3,3,26,36,62
1374,Micronesia,Asia,2018,F,1,1,37,56,93
1375,Moldova,Eurasia,2018,PF,3,3,26,35,61
1376,Monaco,Europe,2018,F,3,1,25,57,82
1377,Mongolia,Asia,2018,F,1,2,36,49,85
1378,Montenegro,Europe,2018,PF,3,3,25,42,67
1379,Morocco,Africa,2018,PF,5,5,14,25,39
1380,Mozambique,Africa,2018,PF,4,4,20,32,52
1381,Myanmar,Asia,2018,PF,5,5,13,18,31
1382,Nagorno-Karabakh,Eurasia,2018,PF,5,5,12,18,30
1383,Namibia,Africa,2018,F,2,2,30,47,77
1384,Nauru,Asia,2018,F,2,2,35,46,81
1385,Nepal,Asia,2018,PF,3,4,25,30,55
1386,Netherlands,Europe,2018,F,1,1,40,59,99
1387,New Zealand,Asia,2018,F,1,1,40,58,98
1388,Nicaragua,Americas,2018,PF,5,4,12,32,44
1389,Niger,Africa,2018,PF,4,4,20,29,49
1390,Nigeria,Africa,2018,PF,3,5,25,25,50
1391,North Korea,Asia,2018,NF,7,7,0,3,3
1392,North Macedonia,Europe,2018,PF,4,3,21,37,58
1393,Northern Cyprus,Europe,2018,F,2,2,31,50,81
1394,Norway,Europe,2018,F,1,1,40,60,100
1395,Oman,Middle East,2018,NF,6,5,6,17,23
1396,Pakistan,Asia,2018,PF,4,5,19,24,43
1397,Pakistani Kashmir,Asia,2018,NF,6,5,9,19,28
1398,Palau,Asia,2018,F,1,1,37,55,92
1399,Panama,Americas,2018,F,2,2,35,48,83
1400,Papua New Guinea,Asia,2018,PF,3,3,25,38,63
1401,Paraguay,Americas,2018,PF,3,3,27,37,64
1402,Peru,Americas,2018,F,2,3,31,42,73
1403,Philippines,Asia,2018,PF,3,3,27,35,62
1404,Poland,Europe,2018,F,1,2,36,49,85
1405,Portugal,Europe,2018,F,1,1,39,58,97
1406,Qatar,Middle East,2018,NF,6,5,7,17,24
1407,Romania,Europe,2018,F,2,2,35,49,84
1408,Russia,Eurasia,2018,NF,7,6,5,15,20
1409,Rwanda,Africa,2018,NF,6,6,8,15,23
1410,Samoa,Asia,2018,F,2,2,30,50,80
1411,San Marino,Europe,2018,F,1,1,38,59,97
1412,Sao Tome and Principe,Africa,2018,F,2,2,34,48,82
1413,Saudi Arabia,Middle East,2018,NF,7,7,0,7,7
1414,Senegal,Africa,2018,F,2,2,31,44,75
1415,Serbia,Europe,2018,F,3,2,28,45,73
1416,Seychelles,Africa,2018,PF,3,3,28,43,71
1417,Sierra Leone,Africa,2018,PF,3,3,28,38,66
1418,Singapore,Asia,2018,PF,4,4,19,33,52
1419,Slovakia,Europe,2018,F,1,1,36,53,89
1420,Slovenia,Europe,2018,F,1,1,39,54,93
1421,Solomon Islands,Asia,2018,F,3,2,28,44,72
1422,Somalia,Africa,2018,NF,7,7,1,6,7
1423,Somaliland,Africa,2018,PF,4,5,19,25,44
1424,South Africa,Africa,2018,F,2,2,32,46,78
1425,South Korea,Asia,2018,F,2,2,33,51,84
1426,South Ossetia,Eurasia,2018,NF,7,6,2,8,10
1427,South Sudan,Africa,2018,NF,7,7,-2,4,2
1428,Spain,Europe,2018,F,1,1,38,56,94
1429,Sri Lanka,Asia,2018,PF,3,4,24,31,55
1430,St. Kitts and Nevis,Americas,2018,F,1,1,36,53,89
1431,St. Lucia,Americas,2018,F,1,1,38,53,91
1432,St. Vincent and the Grenadines,Americas,2018,F,1,1,36,54,90
1433,Sudan,Africa,2018,NF,7,7,4,4,8
1434,Suriname,Americas,2018,F,2,2,34,44,78
1435,Sweden,Europe,2018,F,1,1,40,60,100
1436,Switzerland,Europe,2018,F,1,1,39,57,96
1437,Syria,Middle East,2018,NF,7,7,-3,2,-1
1438,Taiwan,Asia,2018,F,1,1,37,56,93
1439,Tajikistan,Eurasia,2018,NF,7,6,1,10,11
1440,Tanzania,Africa,2018,PF,4,4,22,30,52
1441,Thailand,Asia,2018,NF,6,5,6,25,31
1442,The Gambia,Africa,2018,PF,4,5,20,21,41
1443,Tibet,Asia,2018,NF,7,7,-2,3,1
1444,Timor-Leste,Asia,2018,F,2,3,32,37,69
1445,Togo,Africa,2018,PF,4,4,18,29,47
1446,Tonga,Asia,2018,F,2,2,30,45,75
1447,Transnistria,Eurasia,2018,NF,6,6,10,14,24
1448,Trinidad and Tobago,Americas,2018,F,2,2,33,48,81
1449,Tunisia,Africa,2018,F,2,3,30,40,70
1450,Turkey,Europe,2018,NF,5,6,16,16,32
1451,Turkmenistan,Eurasia,2018,NF,7,7,0,4,4
1452,Tuvalu,Asia,2018,F,1,1,37,57,94
1453,Uganda,Africa,2018,PF,6,4,11,26,37
1454,Ukraine,Eurasia,2018,PF,3,3,26,36,62
1455,United Arab Emirates,Middle East,2018,NF,7,6,5,12,17
1456,United Kingdom,Europe,2018,F,1,1,40,54,94
1457,United States,Americas,2018,F,2,1,33,53,86
1458,Uruguay,Americas,2018,F,1,1,40,58,98
1459,Uzbekistan,Eurasia,2018,NF,7,7,1,6,7
1460,Vanuatu,Asia,2018,F,2,2,33,48,81
1461,Venezuela,Americas,2018,NF,6,5,8,18,26
1462,Vietnam,Asia,2018,NF,7,5,3,17,20
1463,West Bank,Middle East,2018,NF,7,5,5,23,28
1464,Western Sahara,Africa,2018,NF,7,7,-3,7,4
1465,Yemen,Middle East,2018,NF,7,6,1,12,13
1466,Zambia,Africa,2018,PF,4,4,22,33,55
1467,Zimbabwe,Africa,2018,NF,6,5,10,20,30
1468,Abkhazia,Eurasia,2017,PF,4,5,18,23,41
1469,Afghanistan,Asia,2017,NF,6,6,10,14,24
1470,Albania,Europe,2017,PF,3,3,28,40,68
1471,Algeria,Africa,2017,NF,6,5,11,24,35
1472,Andorra,Europe,2017,F,1,1,39,56,95
1473,Angola,Africa,2017,NF,6,6,10,14,24
1474,Antigua and Barbuda,Americas,2017,F,2,2,33,50,83
1475,Argentina,Americas,2017,F,2,2,33,49,82
1476,Armenia,Eurasia,2017,PF,5,4,16,29,45
1477,Australia,Asia,2017,F,1,1,40,58,98
1478,Austria,Europe,2017,F,1,1,37,58,95
1479,Azerbaijan,Eurasia,2017,NF,7,6,4,10,14
1480,Bahamas,Americas,2017,F,1,1,38,53,91
1481,Bahrain,Middle East,2017,NF,7,6,2,10,12
1482,Bangladesh,Asia,2017,PF,4,4,20,27,47
1483,Barbados,Americas,2017,F,1,1,40,58,98
1484,Belarus,Eurasia,2017,NF,7,6,5,15,20
1485,Belgium,Europe,2017,F,1,1,40,55,95
1486,Belize,Americas,2017,F,1,2,36,51,87
1487,Benin,Africa,2017,F,2,2,33,49,82
1488,Bhutan,Asia,2017,PF,3,4,28,27,55
1489,Bolivia,Americas,2017,PF,3,3,29,39,68
1490,Bosnia and Herzegovina,Europe,2017,PF,4,4,21,34,55
1491,Botswana,Africa,2017,F,3,2,28,44,72
1492,Brazil,Americas,2017,F,2,2,31,48,79
1493,Brunei,Asia,2017,NF,6,5,7,22,29
1494,Bulgaria,Europe,2017,F,2,2,33,47,80
1495,Burkina Faso,Africa,2017,PF,4,3,23,40,63
1496,Burundi,Africa,2017,NF,7,6,5,14,19
1497,Cabo Verde,Africa,2017,F,1,1,37,53,90
1498,Cambodia,Asia,2017,NF,6,5,11,20,31
1499,Cameroon,Africa,2017,NF,6,6,9,15,24
1500,Canada,Americas,2017,F,1,1,40,59,99
1501,Central African Republic,Africa,2017,NF,7,7,4,6,10
1502,Chad,Africa,2017,NF,7,6,4,14,18
1503,Chile,Americas,2017,F,1,1,37,57,94
1504,China,Asia,2017,NF,7,6,1,14,15
1505,Colombia,Americas,2017,PF,3,3,29,35,64
1506,Comoros,Africa,2017,PF,3,4,24,31,55
1507,Congo (Brazzaville),Africa,2017,NF,7,5,5,22,27
1508,Congo (Kinshasa),Africa,2017,NF,7,6,4,15,19
1509,Costa Rica,Americas,2017,F,1,1,38,53,91
1510,Cote d'Ivoire,Africa,2017,PF,4,4,20,32,52
1511,Crimea,Eurasia,2017,NF,7,6,-1,10,9
1512,Croatia,Europe,2017,F,1,2,37,50,87
1513,Cuba,Americas,2017,NF,7,6,1,14,15
1514,Cyprus,Europe,2017,F,1,1,38,56,94
1515,Czech Republic,Europe,2017,F,1,1,38,56,94
1516,Denmark,Europe,2017,F,1,1,40,57,97
1517,Djibouti,Africa,2017,NF,6,5,7,19,26
1518,Dominica,Americas,2017,F,1,1,38,57,95
1519,Dominican Republic,Americas,2017,PF,3,3,27,41,68
1520,Ecuador,Americas,2017,PF,3,4,24,33,57
1521,Egypt,Africa,2017,NF,6,5,9,17,26
1522,El Salvador,Americas,2017,F,2,3,34,36,70
1523,Equatorial Guinea,Africa,2017,NF,7,7,1,7,8
1524,Eritrea,Africa,2017,NF,7,7,1,2,3
1525,Estonia,Europe,2017,F,1,1,38,56,94
1526,Eswatini,Africa,2017,NF,7,5,1,17,18
1527,Ethiopia,Africa,2017,NF,7,6,4,8,12
1528,Fiji,Asia,2017,PF,3,4,25,34,59
1529,Finland,Europe,2017,F,1,1,40,60,100
1530,France,Europe,2017,F,1,2,38,52,90
1531,Gabon,Africa,2017,NF,6,5,8,24,32
1532,Gaza Strip,Middle East,2017,NF,7,6,3,9,12
1533,Georgia,Eurasia,2017,PF,3,3,27,37,64
1534,Germany,Europe,2017,F,1,1,39,56,95
1535,Ghana,Africa,2017,F,1,2,37,46,83
1536,Greece,Europe,2017,F,2,2,35,49,84
1537,Grenada,Americas,2017,F,1,2,38,51,89
1538,Guatemala,Americas,2017,PF,4,4,23,31,54
1539,Guinea,Africa,2017,PF,5,5,17,24,41
1540,Guinea-Bissau,Africa,2017,PF,5,5,16,24,40
1541,Guyana,Americas,2017,F,2,3,32,42,74
1542,Haiti,Americas,2017,PF,5,5,15,24,39
1543,Honduras,Americas,2017,PF,4,4,19,27,46
1544,Hong Kong,Asia,2017,PF,5,2,16,45,61
1545,Hungary,Europe,2017,F,3,2,29,47,76
1546,Iceland,Europe,2017,F,1,1,38,59,97
1547,India,Asia,2017,F,2,3,35,42,77
1548,Indian Kashmir,Asia,2017,PF,4,4,22,28,50
1549,Indonesia,Asia,2017,PF,2,4,31,34,65
1550,Iran,Middle East,2017,NF,6,6,7,10,17
1551,Iraq,Middle East,2017,NF,5,6,12,15,27
1552,Ireland,Europe,2017,F,1,1,39,57,96
1553,Israel,Middle East,2017,F,1,2,36,44,80
1554,Italy,Europe,2017,F,1,1,36,53,89
1555,Jamaica,Americas,2017,F,2,3,34,41,75
1556,Japan,Asia,2017,F,1,1,40,56,96
1557,Jordan,Middle East,2017,PF,5,5,12,25,37
1558,Kazakhstan,Eurasia,2017,NF,7,5,5,17,22
1559,Kenya,Africa,2017,PF,4,4,22,29,51
1560,Kiribati,Asia,2017,F,1,1,37,55,92
1561,Kosovo,Europe,2017,PF,3,4,24,28,52
1562,Kuwait,Middle East,2017,PF,5,5,13,23,36
1563,Kyrgyzstan,Eurasia,2017,PF,5,5,13,24,37
1564,Laos,Asia,2017,NF,7,6,1,11,12
1565,Latvia,Europe,2017,F,1,2,36,51,87
1566,Lebanon,Middle East,2017,PF,5,4,14,30,44
1567,Lesotho,Africa,2017,PF,3,3,27,37,64
1568,Liberia,Africa,2017,PF,3,4,28,34,62
1569,Libya,Africa,2017,NF,7,6,3,10,13
1570,Liechtenstein,Europe,2017,F,2,1,33,58,91
1571,Lithuania,Europe,2017,F,1,1,38,53,91
1572,Luxembourg,Europe,2017,F,1,1,38,60,98
1573,Madagascar,Africa,2017,PF,3,4,24,32,56
1574,Malawi,Africa,2017,PF,3,3,26,37,63
1575,Malaysia,Asia,2017,PF,4,4,18,26,44
1576,Maldives,Asia,2017,PF,5,5,17,23,40
1577,Mali,Africa,2017,PF,5,4,17,28,45
1578,Malta,Europe,2017,F,1,1,39,57,96
1579,Marshall Islands,Asia,2017,F,1,1,37,55,92
1580,Mauritania,Africa,2017,NF,6,5,9,21,30
1581,Mauritius,Africa,2017,F,1,2,37,52,89
1582,Mexico,Americas,2017,PF,3,3,28,37,65
1583,Micronesia,Asia,2017,F,1,1,37,56,93
1584,Moldova,Eurasia,2017,PF,3,3,27,35,62
1585,Monaco,Europe,2017,F,3,1,27,57,84
1586,Mongolia,Asia,2017,F,1,2,36,49,85
1587,Montenegro,Europe,2017,PF,3,3,26,43,69
1588,Morocco,Africa,2017,PF,5,4,15,26,41
1589,Mozambique,Africa,2017,PF,4,4,20,33,53
1590,Myanmar,Asia,2017,PF,5,5,14,18,32
1591,Nagorno-Karabakh,Eurasia,2017,PF,5,5,15,18,33
1592,Namibia,Africa,2017,F,2,2,30,47,77
1593,Nauru,Asia,2017,F,2,2,35,46,81
1594,Nepal,Asia,2017,PF,3,4,24,28,52
1595,Netherlands,Europe,2017,F,1,1,40,59,99
1596,New Zealand,Asia,2017,F,1,1,40,58,98
1597,Nicaragua,Americas,2017,PF,5,4,14,33,47
1598,Niger,Africa,2017,PF,4,4,21,28,49
1599,Nigeria,Africa,2017,PF,3,5,25,25,50
1600,North Korea,Asia,2017,NF,7,7,0,3,3
1601,North Macedonia,Europe,2017,PF,4,3,21,36,57
1602,Northern Cyprus,Europe,2017,F,2,2,32,48,80
1603,Norway,Europe,2017,F,1,1,40,60,100
1604,Oman,Middle East,2017,NF,6,5,8,17,25
1605,Pakistan,Asia,2017,PF,4,5,21,22,43
1606,Pakistani Kashmir,Asia,2017,NF,6,5,9,19,28
1607,Palau,Asia,2017,F,1,1,37,55,92
1608,Panama,Americas,2017,F,2,2,35,48,83
1609,Papua New Guinea,Asia,2017,PF,3,3,26,38,64
1610,Paraguay,Americas,2017,PF,3,3,27,37,64
1611,Peru,Americas,2017,F,2,3,31,41,72
1612,Philippines,Asia,2017,PF,3,3,27,36,63
1613,Poland,Europe,2017,F,1,2,37,52,89
1614,Portugal,Europe,2017,F,1,1,39,58,97
1615,Qatar,Middle East,2017,NF,6,5,9,17,26
1616,Romania,Europe,2017,F,2,2,35,49,84
1617,Russia,Eurasia,2017,NF,7,6,5,15,20
1618,Rwanda,Africa,2017,NF,6,6,8,16,24
1619,Samoa,Asia,2017,F,2,2,30,50,80
1620,San Marino,Europe,2017,F,1,1,38,59,97
1621,Sao Tome and Principe,Africa,2017,F,2,2,34,47,81
1622,Saudi Arabia,Middle East,2017,NF,7,7,3,7,10
1623,Senegal,Africa,2017,F,2,2,32,46,78
1624,Serbia,Europe,2017,F,3,2,29,47,76
1625,Seychelles,Africa,2017,PF,3,3,28,43,71
1626,Sierra Leone,Africa,2017,PF,3,3,28,38,66
1627,Singapore,Asia,2017,PF,4,4,19,32,51
1628,Slovakia,Europe,2017,F,1,1,36,53,89
1629,Slovenia,Europe,2017,F,1,1,39,53,92
1630,Solomon Islands,Asia,2017,F,3,2,27,44,71
1631,Somalia,Africa,2017,NF,7,7,0,5,5
1632,Somaliland,Africa,2017,PF,5,5,15,25,40
1633,South Africa,Africa,2017,F,2,2,33,45,78
1634,South Korea,Asia,2017,F,2,2,32,50,82
1635,South Ossetia,Eurasia,2017,NF,7,6,2,9,11
1636,South Sudan,Africa,2017,NF,7,7,-2,6,4
1637,Spain,Europe,2017,F,1,1,38,56,94
1638,Sri Lanka,Asia,2017,PF,3,4,24,32,56
1639,St. Kitts and Nevis,Americas,2017,F,1,1,36,53,89
1640,St. Lucia,Americas,2017,F,1,1,39,53,92
1641,St. Vincent and the Grenadines,Americas,2017,F,1,1,37,54,91
1642,Sudan,Africa,2017,NF,7,7,2,4,6
1643,Suriname,Americas,2017,F,2,3,34,43,77
1644,Sweden,Europe,2017,F,1,1,40,60,100
1645,Switzerland,Europe,2017,F,1,1,39,57,96
1646,Syria,Middle East,2017,NF,7,7,-3,2,-1
1647,Taiwan,Asia,2017,F,1,1,37,54,91
1648,Tajikistan,Eurasia,2017,NF,7,6,1,10,11
1649,Tanzania,Africa,2017,PF,3,4,25,33,58
1650,Thailand,Asia,2017,NF,6,5,7,25,32
1651,The Gambia,Africa,2017,NF,6,6,8,12,20
1652,Tibet,Asia,2017,NF,7,7,-2,3,1
1653,Timor-Leste,Asia,2017,PF,3,3,29,36,65
1654,Togo,Africa,2017,PF,4,4,18,30,48
1655,Tonga,Asia,2017,F,2,2,30,44,74
1656,Transnistria,Eurasia,2017,NF,6,6,10,14,24
1657,Trinidad and Tobago,Americas,2017,F,2,2,33,48,81
1658,Tunisia,Africa,2017,F,1,3,36,42,78
1659,Turkey,Europe,2017,PF,4,5,18,20,38
1660,Turkmenistan,Eurasia,2017,NF,7,7,0,4,4
1661,Tuvalu,Asia,2017,F,1,1,37,57,94
1662,Uganda,Africa,2017,NF,6,5,11,24,35
1663,Ukraine,Eurasia,2017,PF,3,3,25,36,61
1664,United Arab Emirates,Middle East,2017,NF,6,6,7,13,20
1665,United Kingdom,Europe,2017,F,1,1,40,55,95
1666,United States,Americas,2017,F,1,1,36,53,89
1667,Uruguay,Americas,2017,F,1,1,40,58,98
1668,Uzbekistan,Eurasia,2017,NF,7,7,0,3,3
1669,Vanuatu,Asia,2017,F,2,2,32,48,80
1670,Venezuela,Americas,2017,NF,6,5,11,19,30
1671,Vietnam,Asia,2017,NF,7,5,3,17,20
1672,West Bank,Middle East,2017,NF,7,5,5,23,28
1673,Western Sahara,Africa,2017,NF,7,7,-3,7,4
1674,Yemen,Middle East,2017,NF,7,6,2,12,14
1675,Zambia,Africa,2017,PF,4,4,23,33,56
1676,Zimbabwe,Africa,2017,PF,5,5,12,20,32
1677,Abkhazia,Eurasia,2016,PF,4,5,19,23,42
1678,Afghanistan,Asia,2016,NF,6,6,10,14,24
1679,Albania,Europe,2016,PF,3,3,27,40,67
1680,Algeria,Africa,2016,NF,6,5,11,24,35
1681,Andorra,Europe,2016,F,1,1,39,57,96
1682,Angola,Africa,2016,NF,6,6,10,14,24
1683,Antigua and Barbuda,Americas,2016,F,2,2,33,49,82
1684,Argentina,Americas,2016,F,2,2,31,48,79
1685,Armenia,Eurasia,2016,PF,5,4,16,30,46
1686,Australia,Asia,2016,F,1,1,40,58,98
1687,Austria,Europe,2016,F,1,1,37,58,95
1688,Azerbaijan,Eurasia,2016,NF,7,6,5,11,16
1689,Bahamas,Americas,2016,F,1,1,38,54,92
1690,Bahrain,Middle East,2016,NF,7,6,4,10,14
1691,Bangladesh,Asia,2016,PF,4,4,21,28,49
1692,Barbados,Americas,2016,F,1,1,40,58,98
1693,Belarus,Eurasia,2016,NF,7,6,4,13,17
1694,Belgium,Europe,2016,F,1,1,40,56,96
1695,Belize,Americas,2016,F,1,2,36,51,87
1696,Benin,Africa,2016,F,2,2,33,49,82
1697,Bhutan,Asia,2016,PF,3,4,29,27,56
1698,Bolivia,Americas,2016,PF,3,3,29,39,68
1699,Bosnia and Herzegovina,Europe,2016,PF,4,3,22,35,57
1700,Botswana,Africa,2016,F,3,2,28,45,73
1701,Brazil,Americas,2016,F,2,2,33,48,81
1702,Brunei,Asia,2016,NF,6,5,7,22,29
1703,Bulgaria,Europe,2016,F,2,2,33,47,80
1704,Burkina Faso,Africa,2016,PF,4,3,21,38,59
1705,Burundi,Africa,2016,NF,7,6,5,14,19
1706,Cabo Verde,Africa,2016,F,1,1,37,53,90
1707,Cambodia,Asia,2016,NF,6,5,11,21,32
1708,Cameroon,Africa,2016,NF,6,6,9,15,24
1709,Canada,Americas,2016,F,1,1,40,59,99
1710,Central African Republic,Africa,2016,NF,7,7,1,6,7
1711,Chad,Africa,2016,NF,7,6,4,16,20
1712,Chile,Americas,2016,F,1,1,38,57,95
1713,China,Asia,2016,NF,7,6,1,15,16
1714,Colombia,Americas,2016,PF,3,4,29,34,63
1715,Comoros,Africa,2016,PF,3,4,24,31,55
1716,Congo (Brazzaville),Africa,2016,NF,6,5,6,22,28
1717,Congo (Kinshasa),Africa,2016,NF,6,6,9,16,25
1718,Costa Rica,Americas,2016,F,1,1,37,53,90
1719,Cote d'Ivoire,Africa,2016,PF,4,4,20,31,51
1720,Crimea,Eurasia,2016,NF,7,6,-1,10,9
1721,Croatia,Europe,2016,F,1,2,37,50,87
1722,Cuba,Americas,2016,NF,7,6,1,14,15
1723,Cyprus,Europe,2016,F,1,1,38,56,94
1724,Czech Republic,Europe,2016,F,1,1,38,57,95
1725,Denmark,Europe,2016,F,1,1,40,58,98
1726,Djibouti,Africa,2016,NF,6,5,9,19,28
1727,Dominica,Americas,2016,F,1,1,38,57,95
1728,Dominican Republic,Americas,2016,PF,3,3,29,41,70
1729,Ecuador,Americas,2016,PF,3,3,24,35,59
1730,Egypt,Africa,2016,NF,6,5,9,18,27
1731,El Salvador,Americas,2016,F,2,3,33,36,69
1732,Equatorial Guinea,Africa,2016,NF,7,7,1,7,8
1733,Eritrea,Africa,2016,NF,7,7,1,2,3
1734,Estonia,Europe,2016,F,1,1,38,56,94
1735,Eswatini,Africa,2016,NF,7,5,1,17,18
1736,Ethiopia,Africa,2016,NF,7,6,4,11,15
1737,Fiji,Asia,2016,PF,3,3,27,35,62
1738,Finland,Europe,2016,F,1,1,40,60,100
1739,France,Europe,2016,F,1,1,38,53,91
1740,Gabon,Africa,2016,NF,6,5,9,25,34
1741,Gaza Strip,Middle East,2016,NF,7,6,3,9,12
1742,Georgia,Eurasia,2016,PF,3,3,27,37,64
1743,Germany,Europe,2016,F,1,1,39,56,95
1744,Ghana,Africa,2016,F,1,2,37,46,83
1745,Greece,Europe,2016,F,2,2,35,48,83
1746,Grenada,Americas,2016,F,1,2,38,51,89
1747,Guatemala,Americas,2016,PF,4,4,23,31,54
1748,Guinea,Africa,2016,PF,5,5,17,23,40
1749,Guinea-Bissau,Africa,2016,PF,5,5,16,23,39
1750,Guyana,Americas,2016,F,2,3,32,42,74
1751,Haiti,Americas,2016,PF,5,5,17,24,41
1752,Honduras,Americas,2016,PF,4,4,19,26,45
1753,Hong Kong,Asia,2016,PF,5,2,16,47,63
1754,Hungary,Europe,2016,F,2,2,32,47,79
1755,Iceland,Europe,2016,F,1,1,40,60,100
1756,India,Asia,2016,F,2,3,35,42,77
1757,Indian Kashmir,Asia,2016,PF,4,4,22,29,51
1758,Indonesia,Asia,2016,PF,2,4,31,34,65
1759,Iran,Middle East,2016,NF,6,6,7,10,17
1760,Iraq,Middle East,2016,NF,5,6,12,15,27
1761,Ireland,Europe,2016,F,1,1,39,57,96
1762,Israel,Middle East,2016,F,1,2,36,44,80
1763,Italy,Europe,2016,F,1,1,36,53,89
1764,Jamaica,Americas,2016,F,2,3,34,41,75
1765,Japan,Asia,2016,F,1,1,40,56,96
1766,Jordan,Middle East,2016,NF,6,5,11,25,36
1767,Kazakhstan,Eurasia,2016,NF,6,5,6,18,24
1768,Kenya,Africa,2016,PF,4,4,22,29,51
1769,Kiribati,Asia,2016,F,1,1,36,55,91
1770,Kosovo,Europe,2016,PF,3,4,24,28,52
1771,Kuwait,Middle East,2016,PF,5,5,13,23,36
1772,Kyrgyzstan,Eurasia,2016,PF,5,5,14,24,38
1773,Laos,Asia,2016,NF,7,6,1,11,12
1774,Latvia,Europe,2016,F,2,2,35,51,86
1775,Lebanon,Middle East,2016,PF,5,4,13,30,43
1776,Lesotho,Africa,2016,PF,3,3,28,39,67
1777,Liberia,Africa,2016,PF,3,4,28,33,61
1778,Libya,Africa,2016,NF,6,6,6,14,20
1779,Liechtenstein,Europe,2016,F,1,1,39,59,98
1780,Lithuania,Europe,2016,F,1,1,38,53,91
1781,Luxembourg,Europe,2016,F,1,1,38,60,98
1782,Madagascar,Africa,2016,PF,3,4,24,32,56
1783,Malawi,Africa,2016,PF,3,3,27,37,64
1784,Malaysia,Asia,2016,PF,4,4,18,27,45
1785,Maldives,Asia,2016,PF,4,5,19,24,43
1786,Mali,Africa,2016,PF,5,4,17,28,45
1787,Malta,Europe,2016,F,1,1,39,57,96
1788,Marshall Islands,Asia,2016,F,1,1,37,55,92
1789,Mauritania,Africa,2016,NF,6,5,9,21,30
1790,Mauritius,Africa,2016,F,1,2,38,52,90
1791,Mexico,Americas,2016,PF,3,3,28,37,65
1792,Micronesia,Asia,2016,F,1,1,37,56,93
1793,Moldova,Eurasia,2016,PF,3,3,25,35,60
1794,Monaco,Europe,2016,F,2,1,31,57,88
1795,Mongolia,Asia,2016,F,1,2,36,50,86
1796,Montenegro,Europe,2016,PF,3,3,27,43,70
1797,Morocco,Africa,2016,PF,5,4,15,26,41
1798,Mozambique,Africa,2016,PF,4,4,22,34,56
1799,Myanmar,Asia,2016,NF,6,5,11,17,28
1800,Nagorno-Karabakh,Eurasia,2016,PF,5,5,15,18,33
1801,Namibia,Africa,2016,F,2,2,30,47,77
1802,Nauru,Asia,2016,F,2,2,35,49,84
1803,Nepal,Asia,2016,PF,3,4,25,26,51
1804,Netherlands,Europe,2016,F,1,1,40,59,99
1805,New Zealand,Asia,2016,F,1,1,40,58,98
1806,Nicaragua,Americas,2016,PF,4,3,19,35,54
1807,Niger,Africa,2016,PF,3,4,24,28,52
1808,Nigeria,Africa,2016,PF,4,5,23,25,48
1809,North Korea,Asia,2016,NF,7,7,0,3,3
1810,North Macedonia,Europe,2016,PF,4,3,22,35,57
1811,Northern Cyprus,Europe,2016,F,2,2,32,47,79
1812,Norway,Europe,2016,F,1,1,40,60,100
1813,Oman,Middle East,2016,NF,6,5,8,17,25
1814,Pakistan,Asia,2016,PF,4,5,20,21,41
1815,Pakistani Kashmir,Asia,2016,NF,6,5,9,19,28
1816,Palau,Asia,2016,F,1,1,37,55,92
1817,Panama,Americas,2016,F,2,2,35,48,83
1818,Papua New Guinea,Asia,2016,PF,4,3,23,36,59
1819,Paraguay,Americas,2016,PF,3,3,27,37,64
1820,Peru,Americas,2016,F,2,3,30,41,71
1821,Philippines,Asia,2016,PF,3,3,27,38,65
1822,Poland,Europe,2016,F,1,1,38,55,93
1823,Portugal,Europe,2016,F,1,1,39,58,97
1824,Puerto Rico,Americas,2016,F,1,1,37,53,90
1825,Qatar,Middle East,2016,NF,6,5,9,18,27
1826,Romania,Europe,2016,F,2,2,34,49,83
1827,Russia,Eurasia,2016,NF,6,6,7,15,22
1828,Rwanda,Africa,2016,NF,6,6,8,16,24
1829,Samoa,Asia,2016,F,2,2,31,49,80
1830,San Marino,Europe,2016,F,1,1,40,60,100
1831,Sao Tome and Principe,Africa,2016,F,2,2,34,47,81
1832,Saudi Arabia,Middle East,2016,NF,7,7,3,7,10
1833,Senegal,Africa,2016,F,2,2,33,45,78
1834,Serbia,Europe,2016,F,2,2,30,48,78
1835,Seychelles,Africa,2016,PF,3,3,26,42,68
1836,Sierra Leone,Africa,2016,PF,3,3,28,37,65
1837,Singapore,Asia,2016,PF,4,4,19,32,51
1838,Slovakia,Europe,2016,F,1,1,36,53,89
1839,Slovenia,Europe,2016,F,1,1,39,53,92
1840,Solomon Islands,Asia,2016,PF,3,3,25,43,68
1841,Somalia,Africa,2016,NF,7,7,0,2,2
1842,Somaliland,Africa,2016,PF,5,5,15,25,40
1843,South Africa,Africa,2016,F,2,2,33,46,79
1844,South Korea,Asia,2016,F,2,2,34,49,83
1845,South Ossetia,Eurasia,2016,NF,7,6,2,9,11
1846,South Sudan,Africa,2016,NF,7,6,2,12,14
1847,Spain,Europe,2016,F,1,1,39,56,95
1848,Sri Lanka,Asia,2016,PF,4,4,23,32,55
1849,St. Kitts and Nevis,Americas,2016,F,2,1,35,53,88
1850,St. Lucia,Americas,2016,F,1,1,39,53,92
1851,St. Vincent and the Grenadines,Americas,2016,F,1,1,37,54,91
1852,Sudan,Africa,2016,NF,7,7,2,4,6
1853,Suriname,Americas,2016,F,2,3,34,43,77
1854,Sweden,Europe,2016,F,1,1,40,60,100
1855,Switzerland,Europe,2016,F,1,1,39,57,96
1856,Syria,Middle East,2016,NF,7,7,-3,2,-1
1857,Taiwan,Asia,2016,F,1,2,37,52,89
1858,Tajikistan,Eurasia,2016,NF,7,6,2,14,16
1859,Tanzania,Africa,2016,PF,3,4,27,33,60
1860,Thailand,Asia,2016,NF,6,5,7,25,32
1861,The Gambia,Africa,2016,NF,7,6,5,13,18
1862,Tibet,Asia,2016,NF,7,7,-2,3,1
1863,Timor-Leste,Asia,2016,PF,3,3,29,36,65
1864,Togo,Africa,2016,PF,4,4,18,30,48
1865,Tonga,Asia,2016,F,2,2,31,44,75
1866,Transnistria,Eurasia,2016,NF,6,6,10,14,24
1867,Trinidad and Tobago,Americas,2016,F,2,2,33,48,81
1868,Tunisia,Africa,2016,F,1,3,37,42,79
1869,Turkey,Europe,2016,PF,3,4,24,29,53
1870,Turkmenistan,Eurasia,2016,NF,7,7,0,4,4
1871,Tuvalu,Asia,2016,F,1,1,37,57,94
1872,Uganda,Africa,2016,NF,6,5,11,25,36
1873,Ukraine,Eurasia,2016,PF,3,3,25,36,61
1874,United Arab Emirates,Middle East,2016,NF,6,6,7,13,20
1875,United Kingdom,Europe,2016,F,1,1,40,55,95
1876,United States,Americas,2016,F,1,1,36,54,90
1877,Uruguay,Americas,2016,F,1,1,40,58,98
1878,Uzbekistan,Eurasia,2016,NF,7,7,0,3,3
1879,Vanuatu,Asia,2016,F,2,2,31,47,78
1880,Venezuela,Americas,2016,PF,5,5,15,20,35
1881,Vietnam,Asia,2016,NF,7,5,3,17,20
1882,West Bank,Middle East,2016,NF,6,5,6,24,30
1883,Western Sahara,Africa,2016,NF,7,7,-3,7,4
1884,Yemen,Middle East,2016,NF,7,6,4,13,17
1885,Zambia,Africa,2016,PF,3,4,26,34,60
1886,Zimbabwe,Africa,2016,PF,5,5,12,20,32
1887,Abkhazia,Eurasia,2015,PF,4,5,18,23,41
1888,Afghanistan,Asia,2015,NF,6,6,11,13,24
1889,Albania,Europe,2015,PF,3,3,27,40,67
1890,Algeria,Africa,2015,NF,6,5,11,23,34
1891,Andorra,Europe,2015,F,1,1,39,57,96
1892,Angola,Africa,2015,NF,6,5,10,18,28
1893,Antigua and Barbuda,Americas,2015,F,2,2,31,49,80
1894,Argentina,Americas,2015,F,2,2,31,49,80
1895,Armenia,Eurasia,2015,PF,5,4,16,30,46
1896,Australia,Asia,2015,F,1,1,39,58,97
1897,Austria,Europe,2015,F,1,1,38,58,96
1898,Azerbaijan,Eurasia,2015,NF,6,6,6,14,20
1899,Bahamas,Americas,2015,F,1,1,38,58,96
1900,Bahrain,Middle East,2015,NF,7,6,5,10,15
1901,Bangladesh,Asia,2015,PF,4,4,21,29,50
1902,Barbados,Americas,2015,F,1,1,40,59,99
1903,Belarus,Eurasia,2015,NF,7,6,4,10,14
1904,Belgium,Europe,2015,F,1,1,40,57,97
1905,Belize,Americas,2015,F,1,2,36,51,87
1906,Benin,Africa,2015,F,2,2,32,49,81
1907,Bhutan,Asia,2015,PF,3,4,29,27,56
1908,Bolivia,Americas,2015,PF,3,3,29,39,68
1909,Bosnia and Herzegovina,Europe,2015,PF,4,3,23,37,60
1910,Botswana,Africa,2015,F,3,2,28,45,73
1911,Brazil,Americas,2015,F,2,2,33,48,81
1912,Brunei,Asia,2015,NF,6,5,7,23,30
1913,Bulgaria,Europe,2015,F,2,2,33,46,79
1914,Burkina Faso,Africa,2015,PF,6,3,9,36,45
1915,Burundi,Africa,2015,NF,6,5,11,21,32
1916,Cabo Verde,Africa,2015,F,1,1,37,53,90
1917,Cambodia,Asia,2015,NF,6,5,11,20,31
1918,Cameroon,Africa,2015,NF,6,6,9,16,25
1919,Canada,Americas,2015,F,1,1,39,59,98
1920,Central African Republic,Africa,2015,NF,7,7,0,6,6
1921,Chad,Africa,2015,NF,7,6,5,16,21
1922,Chile,Americas,2015,F,1,1,39,56,95
1923,China,Asia,2015,NF,7,6,2,15,17
1924,Colombia,Americas,2015,PF,3,4,29,34,63
1925,Comoros,Africa,2015,PF,3,4,25,30,55
1926,Congo (Brazzaville),Africa,2015,NF,6,5,7,23,30
1927,Congo (Kinshasa),Africa,2015,NF,6,6,9,16,25
1928,Costa Rica,Americas,2015,F,1,1,37,53,90
1929,Cote d'Ivoire,Africa,2015,PF,5,4,17,29,46
1930,Crimea,Eurasia,2015,NF,7,6,-1,11,10
1931,Croatia,Europe,2015,F,1,2,36,50,86
1932,Cuba,Americas,2015,NF,7,6,1,13,14
1933,Cyprus,Europe,2015,F,1,1,37,56,93
1934,Czech Republic,Europe,2015,F,1,1,38,57,95
1935,Denmark,Europe,2015,F,1,1,40,58,98
1936,Djibouti,Africa,2015,NF,6,5,9,19,28
1937,Dominica,Americas,2015,F,1,1,38,57,95
1938,Dominican Republic,Americas,2015,F,2,3,30,43,73
1939,Ecuador,Americas,2015,PF,3,3,24,35,59
1940,Egypt,Africa,2015,NF,6,5,8,18,26
1941,El Salvador,Americas,2015,F,2,3,35,40,75
1942,Equatorial Guinea,Africa,2015,NF,7,7,1,7,8
1943,Eritrea,Africa,2015,NF,7,7,1,2,3
1944,Estonia,Europe,2015,F,1,1,39,56,95
1945,Eswatini,Africa,2015,NF,7,5,1,17,18
1946,Ethiopia,Africa,2015,NF,6,6,7,11,18
1947,Fiji,Asia,2015,PF,3,4,26,34,60
1948,Finland,Europe,2015,F,1,1,40,60,100
1949,France,Europe,2015,F,1,1,38,57,95
1950,Gabon,Africa,2015,NF,6,5,9,25,34
1951,Gaza Strip,Middle East,2015,NF,7,6,5,10,15
1952,Georgia,Eurasia,2015,PF,3,3,26,38,64
1953,Germany,Europe,2015,F,1,1,39,57,96
1954,Ghana,Africa,2015,F,1,2,37,47,84
1955,Greece,Europe,2015,F,2,2,35,48,83
1956,Grenada,Americas,2015,F,1,2,38,51,89
1957,Guatemala,Americas,2015,PF,3,4,24,31,55
1958,Guinea,Africa,2015,PF,5,5,17,24,41
1959,Guinea-Bissau,Africa,2015,PF,5,5,17,23,40
1960,Guyana,Americas,2015,F,2,3,30,41,71
1961,Haiti,Americas,2015,PF,5,5,17,24,41
1962,Honduras,Americas,2015,PF,4,4,20,29,49
1963,Hong Kong,Asia,2015,PF,5,2,16,49,65
1964,Hungary,Europe,2015,F,2,2,32,50,82
1965,Iceland,Europe,2015,F,1,1,39,60,99
1966,India,Asia,2015,F,2,3,35,43,78
1967,Indian Kashmir,Asia,2015,PF,4,4,22,29,51
1968,Indonesia,Asia,2015,PF,2,4,30,34,64
1969,Iran,Middle East,2015,NF,6,6,7,10,17
1970,Iraq,Middle East,2015,NF,6,6,11,13,24
1971,Ireland,Europe,2015,F,1,1,39,58,97
1972,Israel,Middle East,2015,F,1,2,36,44,80
1973,Italy,Europe,2015,F,1,1,36,53,89
1974,Jamaica,Americas,2015,F,2,3,34,40,74
1975,Japan,Asia,2015,F,1,1,39,55,94
1976,Jordan,Middle East,2015,NF,6,5,11,25,36
1977,Kazakhstan,Eurasia,2015,NF,6,5,6,18,24
1978,Kenya,Africa,2015,PF,4,4,22,29,51
1979,Kiribati,Asia,2015,F,1,1,36,55,91
1980,Kosovo,Europe,2015,PF,4,4,23,29,52
1981,Kuwait,Middle East,2015,PF,5,5,14,23,37
1982,Kyrgyzstan,Eurasia,2015,PF,5,5,14,24,38
1983,Laos,Asia,2015,NF,7,6,1,11,12
1984,Latvia,Europe,2015,F,2,2,34,51,85
1985,Lebanon,Middle East,2015,PF,5,4,14,30,44
1986,Lesotho,Africa,2015,F,2,3,30,41,71
1987,Liberia,Africa,2015,PF,3,4,26,30,56
1988,Libya,Africa,2015,NF,6,6,8,15,23
1989,Liechtenstein,Europe,2015,F,1,1,39,59,98
1990,Lithuania,Europe,2015,F,1,1,38,53,91
1991,Luxembourg,Europe,2015,F,1,1,38,60,98
1992,Madagascar,Africa,2015,PF,4,4,22,30,52
1993,Malawi,Africa,2015,PF,3,4,27,34,61
1994,Malaysia,Asia,2015,PF,4,4,19,27,46
1995,Maldives,Asia,2015,PF,4,4,20,28,48
1996,Mali,Africa,2015,PF,5,4,17,27,44
1997,Malta,Europe,2015,F,1,1,39,58,97
1998,Marshall Islands,Asia,2015,F,1,1,36,55,91
1999,Mauritania,Africa,2015,NF,6,5,9,22,31
2000,Mauritius,Africa,2015,F,1,2,38,52,90
2001,Mexico,Americas,2015,PF,3,3,28,36,64
2002,Micronesia,Asia,2015,F,1,1,37,56,93
2003,Moldova,Eurasia,2015,PF,3,3,28,35,63
2004,Monaco,Europe,2015,F,2,1,31,57,88
2005,Mongolia,Asia,2015,F,1,2,36,50,86
2006,Montenegro,Europe,2015,F,3,2,27,44,71
2007,Morocco,Africa,2015,PF,5,4,15,27,42
2008,Mozambique,Africa,2015,PF,4,3,23,35,58
2009,Myanmar,Asia,2015,NF,6,6,9,16,25
2010,Nagorno-Karabakh,Eurasia,2015,PF,5,5,12,18,30
2011,Namibia,Africa,2015,F,2,2,30,46,76
2012,Nauru,Asia,2015,F,1,2,37,51,88
2013,Nepal,Asia,2015,PF,3,4,24,27,51
2014,Netherlands,Europe,2015,F,1,1,40,59,99
2015,New Zealand,Asia,2015,F,1,1,39,58,97
2016,Nicaragua,Americas,2015,PF,4,3,19,35,54
2017,Niger,Africa,2015,PF,3,4,26,30,56
2018,Nigeria,Africa,2015,PF,4,5,18,25,43
2019,North Korea,Asia,2015,NF,7,7,0,3,3
2020,North Macedonia,Europe,2015,PF,4,3,23,37,60
2021,Northern Cyprus,Europe,2015,F,2,2,32,47,79
2022,Norway,Europe,2015,F,1,1,40,60,100
2023,Oman,Middle East,2015,NF,6,5,9,17,26
2024,Pakistan,Asia,2015,PF,4,5,20,22,42
2025,Pakistani Kashmir,Asia,2015,NF,6,5,9,20,29
2026,Palau,Asia,2015,F,1,1,37,55,92
2027,Panama,Americas,2015,F,2,2,35,47,82
2028,Papua New Guinea,Asia,2015,PF,4,3,23,36,59
2029,Paraguay,Americas,2015,PF,3,3,27,38,65
2030,Peru,Americas,2015,F,2,3,30,41,71
2031,Philippines,Asia,2015,PF,3,3,26,37,63
2032,Poland,Europe,2015,F,1,1,38,55,93
2033,Portugal,Europe,2015,F,1,1,39,58,97
2034,Puerto Rico,Americas,2015,F,1,2,37,52,89
2035,Qatar,Middle East,2015,NF,6,5,10,18,28
2036,Romania,Europe,2015,F,2,2,34,49,83
2037,Russia,Eurasia,2015,NF,6,6,7,16,23
2038,Rwanda,Africa,2015,NF,6,6,9,16,25
2039,Samoa,Asia,2015,F,2,2,32,49,81
2040,San Marino,Europe,2015,F,1,1,40,60,100
2041,Sao Tome and Principe,Africa,2015,F,2,2,34,47,81
2042,Saudi Arabia,Middle East,2015,NF,7,7,3,7,10
2043,Senegal,Africa,2015,F,2,2,33,45,78
2044,Serbia,Europe,2015,F,2,2,31,49,80
2045,Seychelles,Africa,2015,PF,3,3,25,42,67
2046,Sierra Leone,Africa,2015,PF,3,3,28,37,65
2047,Singapore,Asia,2015,PF,4,4,19,32,51
2048,Slovakia,Europe,2015,F,1,1,37,53,90
2049,Slovenia,Europe,2015,F,1,1,38,53,91
2050,Solomon Islands,Asia,2015,PF,3,3,25,43,68
2051,Somalia,Africa,2015,NF,7,7,0,2,2
2052,Somaliland,Africa,2015,PF,4,5,21,25,46
2053,South Africa,Africa,2015,F,2,2,33,48,81
2054,South Korea,Asia,2015,F,2,2,34,50,84
2055,South Ossetia,Eurasia,2015,NF,7,6,1,9,10
2056,South Sudan,Africa,2015,NF,7,6,2,13,15
2057,Spain,Europe,2015,F,1,1,39,57,96
2058,Sri Lanka,Asia,2015,PF,5,5,16,25,41
2059,St. Kitts and Nevis,Americas,2015,F,1,1,37,53,90
2060,St. Lucia,Americas,2015,F,1,1,39,53,92
2061,St. Vincent and the Grenadines,Americas,2015,F,1,1,36,54,90
2062,Sudan,Africa,2015,NF,7,7,2,4,6
2063,Suriname,Americas,2015,F,2,2,33,44,77
2064,Sweden,Europe,2015,F,1,1,40,59,99
2065,Switzerland,Europe,2015,F,1,1,39,57,96
2066,Syria,Middle East,2015,NF,7,7,-3,2,-1
2067,Taiwan,Asia,2015,F,1,2,37,51,88
2068,Tajikistan,Eurasia,2015,NF,6,6,7,15,22
2069,Tanzania,Africa,2015,PF,3,3,28,35,63
2070,Thailand,Asia,2015,NF,6,5,8,25,33
2071,The Gambia,Africa,2015,NF,6,6,7,13,20
2072,Tibet,Asia,2015,NF,7,7,-2,3,1
2073,Timor-Leste,Asia,2015,PF,3,3,29,36,65
2074,Togo,Africa,2015,PF,4,4,18,29,47
2075,Tonga,Asia,2015,F,2,2,31,44,75
2076,Transnistria,Eurasia,2015,NF,6,6,10,14,24
2077,Trinidad and Tobago,Americas,2015,F,2,2,33,48,81
2078,Tunisia,Africa,2015,F,1,3,36,43,79
2079,Turkey,Europe,2015,PF,3,4,26,29,55
2080,Turkmenistan,Eurasia,2015,NF,7,7,1,5,6
2081,Tuvalu,Asia,2015,F,1,1,37,57,94
2082,Uganda,Africa,2015,NF,6,5,11,25,36
2083,Ukraine,Eurasia,2015,PF,3,3,25,37,62
2084,United Arab Emirates,Middle East,2015,NF,6,6,8,13,21
2085,United Kingdom,Europe,2015,F,1,1,40,57,97
2086,United States,Americas,2015,F,1,1,37,55,92
2087,Uruguay,Americas,2015,F,1,1,40,58,98
2088,Uzbekistan,Eurasia,2015,NF,7,7,0,4,4
2089,Vanuatu,Asia,2015,F,2,2,32,47,79
2090,Venezuela,Americas,2015,PF,5,5,13,22,35
2091,Vietnam,Asia,2015,NF,7,5,3,17,20
2092,West Bank,Middle East,2015,NF,6,5,6,25,31
2093,Western Sahara,Africa,2015,NF,7,7,-2,7,5
2094,Yemen,Middle East,2015,NF,6,6,9,16,25
2095,Zambia,Africa,2015,PF,3,4,26,34,60
2096,Zimbabwe,Africa,2015,NF,5,6,12,16,28
2097,Abkhazia,Eurasia,2014,PF,4,5,18,22,40
2098,Afghanistan,Asia,2014,NF,6,6,11,15,26
2099,Albania,Europe,2014,PF,3,3,27,40,67
2100,Algeria,Africa,2014,NF,6,5,11,23,34
2101,Andorra,Europe,2014,F,1,1,39,57,96
2102,Angola,Africa,2014,NF,6,5,11,18,29
2103,Antigua and Barbuda,Americas,2014,F,2,2,31,49,80
2104,Argentina,Americas,2014,F,2,2,31,49,80
2105,Armenia,Eurasia,2014,PF,5,4,14,29,43
2106,Australia,Asia,2014,F,1,1,39,58,97
2107,Austria,Europe,2014,F,1,1,38,58,96
2108,Azerbaijan,Eurasia,2014,NF,6,6,6,16,22
2109,Bahamas,Americas,2014,F,1,1,38,58,96
2110,Bahrain,Middle East,2014,NF,6,6,6,10,16
2111,Bangladesh,Asia,2014,PF,3,4,24,29,53
2112,Barbados,Americas,2014,F,1,1,40,59,99
2113,Belarus,Eurasia,2014,NF,7,6,4,10,14
2114,Belgium,Europe,2014,F,1,1,40,57,97
2115,Belize,Americas,2014,F,1,2,36,51,87
2116,Benin,Africa,2014,F,2,2,32,48,80
2117,Bhutan,Asia,2014,PF,3,4,28,27,55
2118,Bolivia,Americas,2014,PF,3,3,29,38,67
2119,Bosnia and Herzegovina,Europe,2014,PF,3,3,24,37,61
2120,Botswana,Africa,2014,F,3,2,28,46,74
2121,Brazil,Americas,2014,F,2,2,33,48,81
2122,Brunei,Asia,2014,NF,6,5,7,23,30
2123,Bulgaria,Europe,2014,F,2,2,31,47,78
2124,Burkina Faso,Africa,2014,PF,5,3,17,36,53
2125,Burundi,Africa,2014,PF,5,5,12,22,34
2126,Cabo Verde,Africa,2014,F,1,1,37,53,90
2127,Cambodia,Asia,2014,NF,6,5,10,20,30
2128,Cameroon,Africa,2014,NF,6,6,8,16,24
2129,Canada,Americas,2014,F,1,1,39,59,98
2130,Central African Republic,Africa,2014,NF,7,7,0,6,6
2131,Chad,Africa,2014,NF,7,6,5,16,21
2132,Chile,Americas,2014,F,1,1,39,56,95
2133,China,Asia,2014,NF,7,6,2,15,17
2134,Colombia,Americas,2014,PF,3,4,28,34,62
2135,Comoros,Africa,2014,PF,3,4,25,30,55
2136,Congo (Brazzaville),Africa,2014,NF,6,5,7,23,30
2137,Congo (Kinshasa),Africa,2014,NF,6,6,9,11,20
2138,Costa Rica,Americas,2014,F,1,1,37,53,90
2139,Cote d'Ivoire,Africa,2014,PF,5,4,17,28,45
2140,Croatia,Europe,2014,F,1,2,36,50,86
2141,Cuba,Americas,2014,NF,7,6,1,11,12
2142,Cyprus,Europe,2014,F,1,1,37,55,92
2143,Czech Republic,Europe,2014,F,1,1,37,57,94
2144,Denmark,Europe,2014,F,1,1,40,58,98
2145,Djibouti,Africa,2014,NF,6,5,9,20,29
2146,Dominica,Americas,2014,F,1,1,38,57,95
2147,Dominican Republic,Americas,2014,F,2,3,30,43,73
2148,Ecuador,Americas,2014,PF,3,3,24,36,60
2149,Egypt,Africa,2014,NF,6,5,9,22,31
2150,El Salvador,Americas,2014,F,2,3,35,42,77
2151,Equatorial Guinea,Africa,2014,NF,7,7,1,7,8
2152,Eritrea,Africa,2014,NF,7,7,1,2,3
2153,Estonia,Europe,2014,F,1,1,39,56,95
2154,Eswatini,Africa,2014,NF,7,5,1,19,20
2155,Ethiopia,Africa,2014,NF,6,6,7,11,18
2156,Fiji,Asia,2014,PF,6,4,7,30,37
2157,Finland,Europe,2014,F,1,1,40,60,100
2158,France,Europe,2014,F,1,1,38,57,95
2159,Gabon,Africa,2014,NF,6,5,9,25,34
2160,Gaza Strip,Middle East,2014,NF,7,6,5,10,15
2161,Georgia,Eurasia,2014,PF,3,3,25,38,63
2162,Germany,Europe,2014,F,1,1,39,57,96
2163,Ghana,Africa,2014,F,1,2,37,47,84
2164,Greece,Europe,2014,F,2,2,35,48,83
2165,Grenada,Americas,2014,F,1,2,38,51,89
2166,Guatemala,Americas,2014,PF,3,4,24,32,56
2167,Guinea,Africa,2014,PF,5,5,17,24,41
2168,Guinea-Bissau,Africa,2014,NF,6,5,9,23,32
2169,Guyana,Americas,2014,F,2,3,31,41,72
2170,Haiti,Americas,2014,PF,4,5,18,25,43
2171,Honduras,Americas,2014,PF,4,4,20,31,51
2172,Hong Kong,Asia,2014,PF,5,2,16,51,67
2173,Hungary,Europe,2014,F,1,2,36,52,88
2174,Iceland,Europe,2014,F,1,1,40,60,100
2175,India,Asia,2014,F,2,3,34,43,77
2176,Indian Kashmir,Asia,2014,PF,4,4,20,29,49
2177,Indonesia,Asia,2014,PF,2,4,30,34,64
2178,Iran,Middle East,2014,NF,6,6,7,10,17
2179,Iraq,Middle East,2014,NF,5,6,12,13,25
2180,Ireland,Europe,2014,F,1,1,39,58,97
2181,Israel,Middle East,2014,F,1,2,36,45,81
2182,Italy,Europe,2014,F,1,1,37,53,90
2183,Jamaica,Americas,2014,F,2,3,34,40,74
2184,Japan,Asia,2014,F,1,1,37,53,90
2185,Jordan,Middle East,2014,NF,6,5,11,24,35
2186,Kazakhstan,Eurasia,2014,NF,6,5,6,19,25
2187,Kenya,Africa,2014,PF,4,4,22,31,53
2188,Kiribati,Asia,2014,F,1,1,36,55,91
2189,Kosovo,Europe,2014,PF,5,4,17,26,43
2190,Kuwait,Middle East,2014,PF,5,5,16,23,39
2191,Kyrgyzstan,Eurasia,2014,PF,5,5,14,25,39
2192,Laos,Asia,2014,NF,7,6,1,11,12
2193,Latvia,Europe,2014,F,2,2,33,51,84
2194,Lebanon,Middle East,2014,PF,5,4,16,32,48
2195,Lesotho,Africa,2014,F,2,3,31,41,72
2196,Liberia,Africa,2014,PF,3,4,26,33,59
2197,Libya,Africa,2014,PF,4,5,21,20,41
2198,Liechtenstein,Europe,2014,F,1,1,39,59,98
2199,Lithuania,Europe,2014,F,1,1,37,53,90
2200,Luxembourg,Europe,2014,F,1,1,39,60,99
2201,Madagascar,Africa,2014,PF,5,4,15,28,43
2202,Malawi,Africa,2014,PF,3,4,26,34,60
2203,Malaysia,Asia,2014,PF,4,4,19,28,47
2204,Maldives,Asia,2014,PF,4,4,19,29,48
2205,Mali,Africa,2014,PF,5,4,17,27,44
2206,Malta,Europe,2014,F,1,1,39,58,97
2207,Marshall Islands,Asia,2014,F,1,1,36,55,91
2208,Mauritania,Africa,2014,NF,6,5,11,23,34
2209,Mauritius,Africa,2014,F,1,2,38,52,90
2210,Mexico,Americas,2014,PF,3,3,28,37,65
2211,Micronesia,Asia,2014,F,1,1,37,56,93
2212,Moldova,Eurasia,2014,PF,3,3,29,35,64
2213,Monaco,Europe,2014,F,2,1,31,57,88
2214,Mongolia,Asia,2014,F,1,2,36,50,86
2215,Montenegro,Europe,2014,F,3,2,27,45,72
2216,Morocco,Africa,2014,PF,5,4,15,27,42
2217,Mozambique,Africa,2014,PF,4,3,23,35,58
2218,Myanmar,Asia,2014,NF,6,5,9,17,26
2219,Nagorno-Karabakh,Eurasia,2014,PF,5,5,12,19,31
2220,Namibia,Africa,2014,F,2,2,30,46,76
2221,Nauru,Asia,2014,F,1,1,38,54,92
2222,Nepal,Asia,2014,PF,4,4,23,27,50
2223,Netherlands,Europe,2014,F,1,1,40,59,99
2224,New Zealand,Asia,2014,F,1,1,39,58,97
2225,Nicaragua,Americas,2014,PF,4,3,19,35,54
2226,Niger,Africa,2014,PF,3,4,26,30,56
2227,Nigeria,Africa,2014,PF,4,4,20,26,46
2228,North Korea,Asia,2014,NF,7,7,0,3,3
2229,North Macedonia,Europe,2014,PF,3,3,26,38,64
2230,Northern Cyprus,Europe,2014,F,2,2,32,47,79
2231,Norway,Europe,2014,F,1,1,40,60,100
2232,Oman,Middle East,2014,NF,6,5,9,17,26
2233,Pakistan,Asia,2014,PF,4,5,21,21,42
2234,Pakistani Kashmir,Asia,2014,NF,6,5,8,21,29
2235,Palau,Asia,2014,F,1,1,37,55,92
2236,Panama,Americas,2014,F,2,2,35,47,82
2237,Papua New Guinea,Asia,2014,PF,3,3,24,36,60
2238,Paraguay,Americas,2014,PF,3,3,26,35,61
2239,Peru,Americas,2014,F,2,3,30,41,71
2240,Philippines,Asia,2014,PF,3,3,26,37,63
2241,Poland,Europe,2014,F,1,1,38,55,93
2242,Portugal,Europe,2014,F,1,1,39,58,97
2243,Puerto Rico,Americas,2014,F,1,2,37,52,89
2244,Qatar,Middle East,2014,NF,6,5,10,18,28
2245,Romania,Europe,2014,F,2,2,35,49,84
2246,Russia,Eurasia,2014,NF,6,5,7,19,26
2247,Rwanda,Africa,2014,NF,6,5,9,17,26
2248,Samoa,Asia,2014,F,2,2,32,49,81
2249,San Marino,Europe,2014,F,1,1,40,60,100
2250,Sao Tome and Principe,Africa,2014,F,2,2,34,47,81
2251,Saudi Arabia,Middle East,2014,NF,7,7,3,7,10
2252,Senegal,Africa,2014,F,2,2,33,46,79
2253,Serbia,Europe,2014,F,2,2,30,48,78
2254,Seychelles,Africa,2014,PF,3,3,25,42,67
2255,Sierra Leone,Africa,2014,PF,3,3,29,38,67
2256,Singapore,Asia,2014,PF,4,4,19,32,51
2257,Slovakia,Europe,2014,F,1,1,37,54,91
2258,Slovenia,Europe,2014,F,1,1,38,53,91
2259,Solomon Islands,Asia,2014,PF,4,3,22,43,65
2260,Somalia,Africa,2014,NF,7,7,0,2,2
2261,Somaliland,Africa,2014,PF,4,5,21,25,46
2262,South Africa,Africa,2014,F,2,2,33,48,81
2263,South Korea,Asia,2014,F,2,2,35,50,85
2264,South Ossetia,Eurasia,2014,NF,7,6,-3,8,5
2265,South Sudan,Africa,2014,NF,6,6,8,16,24
2266,Spain,Europe,2014,F,1,1,39,57,96
2267,Sri Lanka,Asia,2014,PF,5,4,16,26,42
2268,St. Kitts and Nevis,Americas,2014,F,1,1,37,53,90
2269,St. Lucia,Americas,2014,F,1,1,39,53,92
2270,St. Vincent and the Grenadines,Americas,2014,F,1,1,36,53,89
2271,Sudan,Africa,2014,NF,7,7,2,5,7
2272,Suriname,Americas,2014,F,2,2,33,44,77
2273,Sweden,Europe,2014,F,1,1,40,59,99
2274,Switzerland,Europe,2014,F,1,1,39,57,96
2275,Syria,Middle East,2014,NF,7,7,-2,3,1
2276,Taiwan,Asia,2014,F,1,2,36,52,88
2277,Tajikistan,Eurasia,2014,NF,6,6,8,16,24
2278,Tanzania,Africa,2014,PF,3,3,29,35,64
2279,Thailand,Asia,2014,PF,4,4,22,32,54
2280,The Gambia,Africa,2014,NF,6,6,7,14,21
2281,Tibet,Asia,2014,NF,7,7,-2,3,1
2282,Timor-Leste,Asia,2014,PF,3,4,29,34,63
2283,Togo,Africa,2014,PF,4,4,18,29,47
2284,Tonga,Asia,2014,F,2,2,31,44,75
2285,Transnistria,Eurasia,2014,NF,6,6,10,14,24
2286,Trinidad and Tobago,Americas,2014,F,2,2,33,48,81
2287,Tunisia,Africa,2014,PF,3,3,27,36,63
2288,Turkey,Europe,2014,PF,3,4,28,32,60
2289,Turkmenistan,Eurasia,2014,NF,7,7,1,6,7
2290,Tuvalu,Asia,2014,F,1,1,37,57,94
2291,Uganda,Africa,2014,PF,6,4,11,26,37
2292,Ukraine,Eurasia,2014,PF,4,3,20,35,55
2293,United Arab Emirates,Middle East,2014,NF,6,6,8,13,21
2294,United Kingdom,Europe,2014,F,1,1,40,57,97
2295,United States,Americas,2014,F,1,1,37,55,92
2296,Uruguay,Americas,2014,F,1,1,40,58,98
2297,Uzbekistan,Eurasia,2014,NF,7,7,0,4,4
2298,Vanuatu,Asia,2014,F,2,2,32,47,79
2299,Venezuela,Americas,2014,PF,5,5,14,24,38
2300,Vietnam,Asia,2014,NF,7,5,3,17,20
2301,West Bank,Middle East,2014,NF,6,5,7,24,31
2302,Western Sahara,Africa,2014,NF,7,7,-2,7,5
2303,Yemen,Middle East,2014,NF,6,6,10,16,26
2304,Zambia,Africa,2014,PF,3,4,25,34,59
2305,Zimbabwe,Africa,2014,NF,5,6,12,16,28
2306,Abkhazia,Eurasia,2013,PF,4,5,18,22,40
2307,Afghanistan,Asia,2013,NF,6,6,11,16,27
2308,Albania,Europe,2013,PF,3,3,24,39,63
2309,Algeria,Africa,2013,NF,6,5,11,24,35
2310,Andorra,Europe,2013,F,1,1,39,57,96
2311,Angola,Africa,2013,NF,6,5,11,19,30
2312,Antigua and Barbuda,Americas,2013,F,2,2,31,49,80
2313,Argentina,Americas,2013,F,2,2,31,49,80
2314,Armenia,Eurasia,2013,PF,5,4,13,29,42
2315,Australia,Asia,2013,F,1,1,39,58,97
2316,Austria,Europe,2013,F,1,1,38,58,96
2317,Azerbaijan,Eurasia,2013,NF,6,5,6,17,23
2318,Bahamas,Americas,2013,F,1,1,38,58,96
2319,Bahrain,Middle East,2013,NF,6,6,6,12,18
2320,Bangladesh,Asia,2013,PF,3,4,25,31,56
2321,Barbados,Americas,2013,F,1,1,40,59,99
2322,Belarus,Eurasia,2013,NF,7,6,4,10,14
2323,Belgium,Europe,2013,F,1,1,40,57,97
2324,Belize,Americas,2013,F,1,2,37,51,88
2325,Benin,Africa,2013,F,2,2,32,50,82
2326,Bhutan,Asia,2013,PF,4,5,22,24,46
2327,Bolivia,Americas,2013,PF,3,3,29,40,69
2328,Bosnia and Herzegovina,Europe,2013,PF,3,3,25,37,62
2329,Botswana,Africa,2013,F,3,2,28,46,74
2330,Brazil,Americas,2013,F,2,2,33,48,81
2331,Brunei,Asia,2013,NF,6,5,7,23,30
2332,Bulgaria,Europe,2013,F,2,2,34,47,81
2333,Burkina Faso,Africa,2013,PF,5,3,17,36,53
2334,Burundi,Africa,2013,PF,5,5,12,22,34
2335,Cabo Verde,Africa,2013,F,1,1,37,53,90
2336,Cambodia,Asia,2013,NF,6,5,9,20,29
2337,Cameroon,Africa,2013,NF,6,6,7,16,23
2338,Canada,Americas,2013,F,1,1,40,58,98
2339,Central African Republic,Africa,2013,PF,5,5,16,19,35
2340,Chad,Africa,2013,NF,7,6,5,16,21
2341,Chile,Americas,2013,F,1,1,39,57,96
2342,China,Asia,2013,NF,7,6,2,15,17
2343,Colombia,Americas,2013,PF,3,4,27,34,61
2344,Comoros,Africa,2013,PF,3,4,25,30,55
2345,Congo (Brazzaville),Africa,2013,NF,6,5,7,22,29
2346,Congo (Kinshasa),Africa,2013,NF,6,6,9,11,20
2347,Costa Rica,Americas,2013,F,1,1,38,53,91
2348,Cote d'Ivoire,Africa,2013,PF,5,5,13,21,34
2349,Croatia,Europe,2013,F,1,2,36,50,86
2350,Cuba,Americas,2013,NF,7,6,1,10,11
2351,Cyprus,Europe,2013,F,1,1,38,55,93
2352,Czech Republic,Europe,2013,F,1,1,38,57,95
2353,Denmark,Europe,2013,F,1,1,40,58,98
2354,Djibouti,Africa,2013,NF,6,5,9,20,29
2355,Dominica,Americas,2013,F,1,1,38,57,95
2356,Dominican Republic,Americas,2013,F,2,2,31,44,75
2357,Ecuador,Americas,2013,PF,3,3,24,36,60
2358,Egypt,Africa,2013,PF,5,5,16,25,41
2359,El Salvador,Americas,2013,F,2,3,35,42,77
2360,Equatorial Guinea,Africa,2013,NF,7,7,1,7,8
2361,Eritrea,Africa,2013,NF,7,7,1,2,3
2362,Estonia,Europe,2013,F,1,1,39,56,95
2363,Eswatini,Africa,2013,NF,7,5,1,20,21
2364,Ethiopia,Africa,2013,NF,6,6,7,11,18
2365,Fiji,Asia,2013,PF,6,4,7,30,37
2366,Finland,Europe,2013,F,1,1,40,60,100
2367,France,Europe,2013,F,1,1,38,57,95
2368,Gabon,Africa,2013,NF,6,5,9,25,34
2369,Gaza Strip,Middle East,2013,NF,6,6,9,10,19
2370,Georgia,Eurasia,2013,PF,3,3,24,36,60
2371,Germany,Europe,2013,F,1,1,39,57,96
2372,Ghana,Africa,2013,F,1,2,37,47,84
2373,Greece,Europe,2013,F,2,2,35,48,83
2374,Grenada,Americas,2013,F,1,2,38,51,89
2375,Guatemala,Americas,2013,PF,3,4,24,33,57
2376,Guinea,Africa,2013,PF,5,5,15,24,39
2377,Guinea-Bissau,Africa,2013,NF,6,5,7,23,30
2378,Guyana,Americas,2013,F,2,3,31,40,71
2379,Haiti,Americas,2013,PF,4,5,19,24,43
2380,Honduras,Americas,2013,PF,4,4,18,33,51
2381,Hong Kong,Asia,2013,PF,5,2,16,51,67
2382,Hungary,Europe,2013,F,1,2,36,52,88
2383,Iceland,Europe,2013,F,1,1,40,60,100
2384,India,Asia,2013,F,2,3,34,42,76
2385,Indian Kashmir,Asia,2013,PF,4,4,20,29,49
2386,Indonesia,Asia,2013,F,2,3,30,35,65
2387,Iran,Middle East,2013,NF,6,6,6,10,16
2388,Iraq,Middle East,2013,NF,6,6,11,13,24
2389,Ireland,Europe,2013,F,1,1,39,58,97
2390,Israel,Middle East,2013,F,1,2,36,45,81
2391,Italy,Europe,2013,F,2,1,35,53,88
2392,Jamaica,Americas,2013,F,2,3,33,40,73
2393,Japan,Asia,2013,F,1,2,37,51,88
2394,Jordan,Middle East,2013,NF,6,5,10,24,34
2395,Kazakhstan,Eurasia,2013,NF,6,5,6,20,26
2396,Kenya,Africa,2013,PF,4,4,21,34,55
2397,Kiribati,Asia,2013,F,1,1,36,55,91
2398,Kosovo,Europe,2013,PF,5,4,16,26,42
2399,Kuwait,Middle East,2013,PF,5,5,17,24,41
2400,Kyrgyzstan,Eurasia,2013,PF,5,5,14,25,39
2401,Laos,Asia,2013,NF,7,6,0,11,11
2402,Latvia,Europe,2013,F,2,2,33,51,84
2403,Lebanon,Middle East,2013,PF,5,4,17,32,49
2404,Lesotho,Africa,2013,F,2,3,31,41,72
2405,Liberia,Africa,2013,PF,3,4,26,34,60
2406,Libya,Africa,2013,PF,4,5,22,21,43
2407,Liechtenstein,Europe,2013,F,1,1,39,59,98
2408,Lithuania,Europe,2013,F,1,1,37,53,90
2409,Luxembourg,Europe,2013,F,1,1,40,60,100
2410,Madagascar,Africa,2013,PF,6,4,7,28,35
2411,Malawi,Africa,2013,PF,3,4,26,34,60
2412,Malaysia,Asia,2013,PF,4,4,20,28,48
2413,Maldives,Asia,2013,PF,5,4,17,29,46
2414,Mali,Africa,2013,NF,7,5,5,19,24
2415,Malta,Europe,2013,F,1,1,39,58,97
2416,Marshall Islands,Asia,2013,F,1,1,36,55,91
2417,Mauritania,Africa,2013,NF,6,5,11,23,34
2418,Mauritius,Africa,2013,F,1,2,38,52,90
2419,Mexico,Americas,2013,PF,3,3,28,37,65
2420,Micronesia,Asia,2013,F,1,1,37,56,93
2421,Moldova,Eurasia,2013,PF,3,3,29,36,65
2422,Monaco,Europe,2013,F,2,1,31,56,87
2423,Mongolia,Asia,2013,F,1,2,36,50,86
2424,Montenegro,Europe,2013,F,3,2,27,45,72
2425,Morocco,Africa,2013,PF,5,4,16,27,43
2426,Mozambique,Africa,2013,PF,4,3,23,36,59
2427,Myanmar,Asia,2013,NF,6,5,9,17,26
2428,Nagorno-Karabakh,Eurasia,2013,PF,5,5,12,19,31
2429,Namibia,Africa,2013,F,2,2,30,46,76
2430,Nauru,Asia,2013,F,1,1,38,55,93
2431,Nepal,Asia,2013,PF,4,4,20,27,47
2432,Netherlands,Europe,2013,F,1,1,40,59,99
2433,New Zealand,Asia,2013,F,1,1,39,58,97
2434,Nicaragua,Americas,2013,PF,5,4,17,34,51
2435,Niger,Africa,2013,PF,3,4,26,30,56
2436,Nigeria,Africa,2013,PF,4,4,20,26,46
2437,North Korea,Asia,2013,NF,7,7,0,3,3
2438,North Macedonia,Europe,2013,PF,3,3,26,38,64
2439,Northern Cyprus,Europe,2013,F,2,2,32,46,78
2440,Norway,Europe,2013,F,1,1,40,60,100
2441,Oman,Middle East,2013,NF,6,5,9,17,26
2442,Pakistan,Asia,2013,PF,4,5,20,22,42
2443,Pakistani Kashmir,Asia,2013,NF,6,5,8,21,29
2444,Palau,Asia,2013,F,1,1,37,55,92
2445,Panama,Americas,2013,F,1,2,36,46,82
2446,Papua New Guinea,Asia,2013,PF,4,3,23,36,59
2447,Paraguay,Americas,2013,PF,3,3,27,35,62
2448,Peru,Americas,2013,F,2,3,30,41,71
2449,Philippines,Asia,2013,PF,3,3,26,37,63
2450,Poland,Europe,2013,F,1,1,38,55,93
2451,Portugal,Europe,2013,F,1,1,39,58,97
2452,Puerto Rico,Americas,2013,F,1,2,37,52,89
2453,Qatar,Middle East,2013,NF,6,5,10,18,28
2454,Romania,Europe,2013,F,2,2,32,49,81
2455,Russia,Eurasia,2013,NF,6,5,7,20,27
2456,Rwanda,Africa,2013,NF,6,6,8,16,24
2457,Samoa,Asia,2013,F,2,2,32,49,81
2458,San Marino,Europe,2013,F,1,1,40,60,100
2459,Sao Tome and Principe,Africa,2013,F,2,2,34,47,81
2460,Saudi Arabia,Middle East,2013,NF,7,7,3,7,10
2461,Senegal,Africa,2013,F,2,3,32,43,75
2462,Serbia,Europe,2013,F,2,2,30,48,78
2463,Seychelles,Africa,2013,PF,3,3,25,42,67
2464,Sierra Leone,Africa,2013,F,2,3,30,40,70
2465,Singapore,Asia,2013,PF,4,4,19,33,52
2466,Slovakia,Europe,2013,F,1,1,37,55,92
2467,Slovenia,Europe,2013,F,1,1,38,53,91
2468,Solomon Islands,Asia,2013,PF,4,3,22,43,65
2469,Somalia,Africa,2013,NF,7,7,0,2,2
2470,Somaliland,Africa,2013,PF,4,5,21,25,46
2471,South Africa,Africa,2013,F,2,2,34,47,81
2472,South Korea,Asia,2013,F,1,2,36,50,86
2473,South Ossetia,Eurasia,2013,NF,7,6,-3,8,5
2474,South Sudan,Africa,2013,NF,6,5,11,20,31
2475,Spain,Europe,2013,F,1,1,39,57,96
2476,Sri Lanka,Asia,2013,PF,5,4,16,27,43
2477,St. Kitts and Nevis,Americas,2013,F,1,1,38,53,91
2478,St. Lucia,Americas,2013,F,1,1,39,54,93
2479,St. Vincent and the Grenadines,Americas,2013,F,1,1,36,53,89
2480,Sudan,Africa,2013,NF,7,7,2,5,7
2481,Suriname,Americas,2013,F,2,2,33,44,77
2482,Sweden,Europe,2013,F,1,1,40,60,100
2483,Switzerland,Europe,2013,F,1,1,39,57,96
2484,Syria,Middle East,2013,NF,7,7,-1,6,5
2485,Taiwan,Asia,2013,F,1,2,36,52,88
2486,Tajikistan,Eurasia,2013,NF,6,6,8,16,24
2487,Tanzania,Africa,2013,PF,3,3,28,38,66
2488,Thailand,Asia,2013,PF,4,4,22,31,53
2489,The Gambia,Africa,2013,NF,6,6,7,16,23
2490,Tibet,Asia,2013,NF,7,7,-2,3,1
2491,Timor-Leste,Asia,2013,PF,3,4,29,34,63
2492,Togo,Africa,2013,PF,5,4,16,27,43
2493,Tonga,Asia,2013,F,3,2,29,44,73
2494,Transnistria,Eurasia,2013,NF,6,6,10,15,25
2495,Trinidad and Tobago,Americas,2013,F,2,2,33,48,81
2496,Tunisia,Africa,2013,PF,3,4,26,33,59
2497,Turkey,Europe,2013,PF,3,4,28,33,61
2498,Turkmenistan,Eurasia,2013,NF,7,7,1,6,7
2499,Tuvalu,Asia,2013,F,1,1,37,57,94
2500,Uganda,Africa,2013,PF,5,4,12,28,40
2501,Ukraine,Eurasia,2013,PF,4,3,21,36,57
2502,United Arab Emirates,Middle East,2013,NF,6,6,8,14,22
2503,United Kingdom,Europe,2013,F,1,1,40,57,97
2504,United States,Americas,2013,F,1,1,37,56,93
2505,Uruguay,Americas,2013,F,1,1,39,58,97
2506,Uzbekistan,Eurasia,2013,NF,7,7,0,4,4
2507,Vanuatu,Asia,2013,F,2,2,32,47,79
2508,Venezuela,Americas,2013,PF,5,5,15,24,39
2509,Vietnam,Asia,2013,NF,7,5,2,17,19
2510,West Bank,Middle East,2013,NF,6,5,6,24,30
2511,Western Sahara,Africa,2013,NF,7,7,-2,7,5
2512,Yemen,Middle East,2013,NF,6,6,9,16,25
2513,Zambia,Africa,2013,PF,3,4,28,34,62
2514,Zimbabwe,Africa,2013,NF,6,6,11,14,25
